SongID,segment_num,segment_start,segment_end,duration,start_beat_idx,end_beat_idx,num_beats,num_components,seg_type
1,1,0.0,15.466666666666667,15.466666666666667,0,33,33,4,chroma_acts
1,2,15.466666666666667,28.426666666666666,12.959999999999999,33,60,27,4,chroma_acts
1,3,28.426666666666666,60.586666666666666,32.16,60,127,67,4,chroma_acts
1,4,60.586666666666666,120.58666666666666,59.99999999999999,127,252,125,4,chroma_acts
1,5,120.58666666666666,148.90666666666664,28.31999999999998,252,311,59,4,chroma_acts
1,6,148.90666666666664,166.18666666666664,17.28,311,347,36,4,chroma_acts
1,7,166.18666666666664,227.14666666666665,60.96000000000001,347,474,127,4,chroma_acts
1,8,227.14666666666665,259.995,32.84833333333336,474,541,67,4,chroma_acts
2,1,0.0,44.25599999999999,44.25599999999999,0,93,93,5,chroma_acts
2,2,44.25599999999999,76.896,32.64000000000001,93,161,68,5,chroma_acts
2,3,76.896,84.576,7.679999999999993,161,177,16,5,chroma_acts
2,4,84.576,91.776,7.200000000000003,177,192,15,5,chroma_acts
2,5,91.776,136.416,44.64,192,285,93,5,chroma_acts
2,6,136.416,169.05599999999998,32.639999999999986,285,353,68,5,chroma_acts
2,7,169.05599999999998,176.736,7.680000000000007,353,369,16,5,chroma_acts
2,8,176.736,183.936,7.200000000000017,369,384,15,5,chroma_acts
2,9,183.936,276.425,92.489,384,575,191,5,chroma_acts
3,1,0.0,13.194666666666667,13.194666666666667,0,28,28,4,chroma_acts
3,2,13.194666666666667,47.27466666666667,34.08,28,99,71,4,chroma_acts
3,3,47.27466666666667,91.43466666666666,44.15999999999999,99,191,92,4,chroma_acts
3,4,91.43466666666666,115.91466666666666,24.480000000000004,191,242,51,4,chroma_acts
3,5,115.91466666666666,123.11466666666666,7.200000000000003,242,257,15,4,chroma_acts
3,6,123.11466666666666,161.51466666666667,38.400000000000006,257,337,80,4,chroma_acts
3,7,161.51466666666667,179.529,18.014333333333326,337,373,36,4,chroma_acts
6,1,0.0,8.682666666666666,8.682666666666666,0,19,19,3,chroma_acts
6,2,8.682666666666666,15.882666666666665,7.199999999999999,19,34,15,3,chroma_acts
6,3,15.882666666666665,31.722666666666665,15.84,34,67,33,3,chroma_acts
6,4,31.722666666666665,61.00266666666666,29.279999999999998,67,128,61,3,chroma_acts
6,5,61.00266666666666,92.20266666666666,31.199999999999996,128,193,65,3,chroma_acts
6,6,92.20266666666666,122.92266666666666,30.72,193,257,64,3,chroma_acts
6,7,122.92266666666666,156.04266666666666,33.120000000000005,257,326,69,3,chroma_acts
6,8,156.04266666666666,203.799,47.756333333333345,326,424,98,3,chroma_acts
7,1,0.0,29.418666666666663,29.418666666666663,0,62,62,5,chroma_acts
7,2,29.418666666666663,57.25866666666666,27.84,62,120,58,5,chroma_acts
7,3,57.25866666666666,80.77866666666667,23.520000000000003,120,169,49,5,chroma_acts
7,4,80.77866666666667,115.33866666666665,34.55999999999999,169,241,72,5,chroma_acts
7,5,115.33866666666665,149.89866666666666,34.56,241,313,72,5,chroma_acts
7,6,149.89866666666666,199.81866666666667,49.920000000000016,313,417,104,5,chroma_acts
7,7,199.81866666666667,233.41866666666667,33.599999999999994,417,487,70,5,chroma_acts
7,8,233.41866666666667,291.4986666666667,58.08000000000001,487,608,121,5,chroma_acts
7,9,291.4986666666667,323.466,31.96733333333333,608,673,65,5,chroma_acts
8,1,0.0,8.575999999999999,8.575999999999999,0,17,17,3,chroma_acts
8,2,8.575999999999999,52.47999999999999,43.90399999999999,17,101,84,3,chroma_acts
8,3,52.47999999999999,65.024,12.544000000000011,101,125,24,3,chroma_acts
8,4,65.024,169.03466666666665,104.01066666666665,125,324,199,3,chroma_acts
8,5,169.03466666666665,173.73866666666666,4.704000000000008,324,333,9,3,chroma_acts
8,6,173.73866666666666,177.3973333333333,3.6586666666666474,333,340,7,3,chroma_acts
8,7,177.3973333333333,181.57866666666666,4.181333333333356,340,348,8,3,chroma_acts
8,8,181.57866666666666,273.391,91.81233333333336,348,522,174,3,chroma_acts
10,1,0.0,46.86933333333334,46.86933333333334,0,96,96,5,chroma_acts
10,2,46.86933333333334,93.48266666666667,46.61333333333334,96,191,95,5,chroma_acts
10,3,93.48266666666667,97.89866666666667,4.415999999999997,191,200,9,5,chroma_acts
10,4,97.89866666666667,101.82400000000001,3.9253333333333416,200,208,8,5,chroma_acts
10,5,101.82400000000001,105.74933333333334,3.9253333333333273,208,216,8,5,chroma_acts
10,6,105.74933333333334,113.60000000000001,7.850666666666669,216,232,16,5,chroma_acts
10,7,113.60000000000001,117.52533333333334,3.9253333333333273,232,240,8,5,chroma_acts
10,8,117.52533333333334,140.58666666666667,23.061333333333337,240,287,47,5,chroma_acts
10,9,140.58666666666667,172.83,32.24333333333334,287,351,64,5,chroma_acts
11,1,0.0,23.808,23.808,0,50,50,4,chroma_acts
11,2,23.808,36.288,12.479999999999997,50,76,26,4,chroma_acts
11,3,36.288,81.888,45.60000000000001,76,171,95,4,chroma_acts
11,4,81.888,85.728,3.839999999999989,171,179,8,4,chroma_acts
11,5,85.728,116.928,31.200000000000003,179,244,65,4,chroma_acts
11,6,116.928,131.808,14.879999999999995,244,275,31,4,chroma_acts
11,7,131.808,170.688,38.879999999999995,275,356,81,4,chroma_acts
11,8,170.688,178.368,7.680000000000007,356,372,16,4,chroma_acts
11,9,178.368,194.056,15.688000000000017,372,403,31,4,chroma_acts
12,1,0.0,23.818666666666665,23.818666666666665,0,49,49,4,chroma_acts
12,2,23.818666666666665,35.104,11.285333333333334,49,72,23,4,chroma_acts
12,3,35.104,45.89866666666667,10.794666666666672,72,94,22,4,chroma_acts
12,4,45.89866666666667,48.352000000000004,2.453333333333333,94,99,5,4,chroma_acts
12,5,48.352000000000004,60.61866666666667,12.266666666666666,99,124,25,4,chroma_acts
12,6,60.61866666666667,87.11466666666666,26.495999999999995,124,178,54,4,chroma_acts
12,7,87.11466666666666,126.36800000000001,39.253333333333345,178,258,80,4,chroma_acts
12,8,126.36800000000001,145.5,19.13199999999999,258,295,37,4,chroma_acts
13,1,0.0,17.397333333333332,17.397333333333332,0,38,38,5,chroma_acts
13,2,17.397333333333332,22.56,5.1626666666666665,38,49,11,5,chroma_acts
13,3,22.56,31.946666666666665,9.386666666666667,49,69,20,5,chroma_acts
13,4,31.946666666666665,92.02133333333333,60.074666666666666,69,197,128,5,chroma_acts
13,5,92.02133333333333,106.57066666666667,14.549333333333337,197,228,31,5,chroma_acts
13,6,106.57066666666667,137.54666666666668,30.976000000000013,228,294,66,5,chroma_acts
13,7,137.54666666666668,144.58666666666667,7.039999999999992,294,309,15,5,chroma_acts
13,8,144.58666666666667,174.375,29.788333333333327,309,371,62,5,chroma_acts
18,1,0.0,25.152,25.152,0,54,54,5,chroma_acts
18,2,25.152,39.70133333333333,14.54933333333333,54,85,31,5,chroma_acts
18,3,39.70133333333333,43.455999999999996,3.7546666666666653,85,93,8,5,chroma_acts
18,4,43.455999999999996,58.474666666666664,15.018666666666668,93,125,32,5,chroma_acts
18,5,58.474666666666664,62.22933333333333,3.7546666666666653,125,133,8,5,chroma_acts
18,6,62.22933333333333,65.984,3.7546666666666653,133,141,8,5,chroma_acts
18,7,65.984,99.776,33.792,141,213,72,5,chroma_acts
18,8,99.776,137.792,38.016000000000005,213,294,81,5,chroma_acts
18,9,137.792,148.594,10.801999999999992,294,316,22,5,chroma_acts
19,1,0.0,30.826666666666664,30.826666666666664,0,65,65,6,chroma_acts
19,2,30.826666666666664,61.06666666666667,30.240000000000006,65,128,63,6,chroma_acts
19,3,61.06666666666667,80.74666666666667,19.68,128,169,41,6,chroma_acts
19,4,80.74666666666667,84.58666666666666,3.839999999999989,169,177,8,6,chroma_acts
19,5,84.58666666666666,95.62666666666667,11.040000000000006,177,200,23,6,chroma_acts
19,6,95.62666666666667,130.18666666666664,34.559999999999974,200,272,72,6,chroma_acts
19,7,130.18666666666664,158.98666666666665,28.80000000000001,272,332,60,6,chroma_acts
19,8,158.98666666666665,190.66666666666666,31.680000000000007,332,398,66,6,chroma_acts
19,9,190.66666666666666,199.462,8.795333333333332,398,415,17,6,chroma_acts
20,1,0.0,32.17066666666666,32.17066666666666,0,65,65,5,chroma_acts
20,2,32.17066666666666,63.75466666666666,31.583999999999996,65,128,63,5,chroma_acts
20,3,63.75466666666666,105.86666666666666,42.112,128,212,84,5,chroma_acts
20,4,105.86666666666666,107.872,2.00533333333334,212,216,4,5,chroma_acts
20,5,107.872,109.87733333333333,2.0053333333333256,216,220,4,5,chroma_acts
20,6,109.87733333333333,113.88799999999999,4.0106666666666655,220,228,8,5,chroma_acts
20,7,113.88799999999999,181.253,67.365,228,361,133,5,chroma_acts
21,1,0.0,39.38133333333333,39.38133333333333,0,83,83,5,chroma_acts
21,2,39.38133333333333,53.78133333333333,14.399999999999999,83,113,30,5,chroma_acts
21,3,53.78133333333333,68.66133333333333,14.880000000000003,113,144,31,5,chroma_acts
21,4,68.66133333333333,100.34133333333332,31.679999999999993,144,210,66,5,chroma_acts
21,5,100.34133333333332,124.82133333333333,24.480000000000004,210,261,51,5,chroma_acts
21,6,124.82133333333333,144.98133333333334,20.16000000000001,261,303,42,5,chroma_acts
21,7,144.98133333333334,160.34133333333332,15.359999999999985,303,335,32,5,chroma_acts
21,8,160.34133333333332,190.58133333333333,30.24000000000001,335,398,63,5,chroma_acts
21,9,190.58133333333333,209.179,18.59766666666667,398,435,37,5,chroma_acts
22,1,0.0,156.69333333333336,156.69333333333336,0,320,320,5,chroma_acts
22,2,156.69333333333336,159.63733333333334,2.9439999999999884,320,326,6,5,chroma_acts
22,3,159.63733333333334,162.58133333333336,2.944000000000017,326,332,6,5,chroma_acts
22,4,162.58133333333336,167.9786666666667,5.397333333333336,332,343,11,5,chroma_acts
22,5,167.9786666666667,170.43200000000002,2.453333333333319,343,348,5,5,chroma_acts
22,6,170.43200000000002,175.33866666666668,4.906666666666666,348,358,10,5,chroma_acts
22,7,175.33866666666668,178.2826666666667,2.944000000000017,358,364,6,5,chroma_acts
22,8,178.2826666666667,184.17066666666668,5.887999999999977,364,376,12,5,chroma_acts
22,9,184.17066666666668,255.37,71.19933333333333,376,520,144,5,chroma_acts
23,1,0.0,32.992,32.992,0,69,69,6,chroma_acts
23,2,32.992,41.152,8.160000000000004,69,86,17,6,chroma_acts
23,3,41.152,63.711999999999996,22.559999999999995,86,133,47,6,chroma_acts
23,4,63.711999999999996,79.55199999999999,15.839999999999996,133,166,33,6,chroma_acts
23,5,79.55199999999999,83.392,3.8400000000000034,166,174,8,6,chroma_acts
23,6,83.392,117.952,34.56,174,246,72,6,chroma_acts
23,7,117.952,140.992,23.039999999999992,246,294,48,6,chroma_acts
23,8,140.992,154.432,13.439999999999998,294,322,28,6,chroma_acts
23,9,154.432,187.831,33.399,322,390,68,6,chroma_acts
25,1,0.0,31.56266666666667,31.56266666666667,0,68,68,4,chroma_acts
25,2,31.56266666666667,60.66133333333333,29.098666666666663,68,130,62,4,chroma_acts
25,3,60.66133333333333,62.06933333333333,1.4080000000000013,130,133,3,4,chroma_acts
25,4,62.06933333333333,77.55733333333333,15.488,133,166,33,4,chroma_acts
25,5,77.55733333333333,108.064,30.50666666666666,166,231,65,4,chroma_acts
25,6,108.064,153.12,45.05600000000001,231,327,96,4,chroma_acts
25,7,153.12,154.528,1.407999999999987,327,330,3,4,chroma_acts
25,8,154.528,168.983,14.455000000000013,330,359,29,4,chroma_acts
26,1,0.0,15.093333333333334,15.093333333333334,0,32,32,5,chroma_acts
26,2,15.093333333333334,32.85333333333333,17.759999999999998,32,69,37,5,chroma_acts
26,3,32.85333333333333,47.733333333333334,14.880000000000003,69,100,31,5,chroma_acts
26,4,47.733333333333334,50.61333333333334,2.8800000000000026,100,106,6,5,chroma_acts
26,5,50.61333333333334,107.25333333333333,56.63999999999999,106,224,118,5,chroma_acts
26,6,107.25333333333333,124.53333333333333,17.28,224,260,36,5,chroma_acts
26,7,124.53333333333333,127.41333333333333,2.8799999999999955,260,266,6,5,chroma_acts
26,8,127.41333333333333,156.744,29.330666666666673,266,326,60,5,chroma_acts
29,1,0.0,28.832,28.832,0,61,61,3,chroma_acts
29,2,28.832,69.152,40.32,61,145,84,3,chroma_acts
29,3,69.152,82.592,13.439999999999998,145,173,28,3,chroma_acts
29,4,82.592,84.512,1.9200000000000017,173,177,4,3,chroma_acts
29,5,84.512,115.71199999999999,31.19999999999999,177,242,65,3,chroma_acts
29,6,115.71199999999999,153.632,37.920000000000016,242,321,79,3,chroma_acts
29,7,153.632,167.072,13.439999999999998,321,349,28,3,chroma_acts
29,8,167.072,168.992,1.9199999999999875,349,353,4,3,chroma_acts
29,9,168.992,215.04,46.048,353,447,94,3,chroma_acts
30,1,0.0,71.30666666666666,71.30666666666666,0,152,152,5,chroma_acts
30,2,71.30666666666666,120.11733333333332,48.81066666666666,152,256,104,5,chroma_acts
30,3,120.11733333333332,125.74933333333333,5.632000000000005,256,268,12,5,chroma_acts
30,4,125.74933333333333,127.62666666666667,1.8773333333333397,268,272,4,5,chroma_acts
30,5,127.62666666666667,131.38133333333332,3.754666666666651,272,280,8,5,chroma_acts
30,6,131.38133333333332,133.25866666666667,1.877333333333354,280,284,4,5,chroma_acts
30,7,133.25866666666667,161.41866666666667,28.159999999999997,284,344,60,5,chroma_acts
30,8,161.41866666666667,213.209,51.790333333333336,344,453,109,5,chroma_acts
32,1,0.0,11.669333333333332,11.669333333333332,0,26,26,4,chroma_acts
32,2,11.669333333333332,26.346666666666664,14.677333333333332,26,58,32,4,chroma_acts
32,3,26.346666666666664,30.016,3.6693333333333342,58,66,8,4,chroma_acts
32,4,30.016,56.618666666666655,26.602666666666657,66,124,58,4,chroma_acts
32,5,56.618666666666655,59.37066666666666,2.7520000000000024,124,130,6,4,chroma_acts
32,6,59.37066666666666,72.21333333333332,12.842666666666666,130,158,28,4,chroma_acts
32,7,72.21333333333332,85.51466666666666,13.301333333333332,158,187,29,4,chroma_acts
32,8,85.51466666666666,89.18399999999998,3.669333333333327,187,195,8,4,chroma_acts
32,9,89.18399999999998,126.845,37.661000000000016,195,276,81,4,chroma_acts
33,1,0.0,11.872,11.872,0,26,26,4,chroma_acts
33,2,11.872,45.19466666666666,33.32266666666666,26,97,71,4,chroma_acts
33,3,45.19466666666666,82.74133333333333,37.54666666666667,97,177,80,4,chroma_acts
33,4,82.74133333333333,97.76,15.018666666666675,177,209,32,4,chroma_acts
33,5,97.76,120.288,22.52799999999999,209,257,48,4,chroma_acts
33,6,120.288,134.83733333333333,14.549333333333337,257,288,31,4,chroma_acts
33,7,134.83733333333333,176.608,41.77066666666667,288,377,89,4,chroma_acts
33,8,176.608,184.787,8.179000000000002,377,393,16,4,chroma_acts
36,1,0.0,16.78933333333333,16.78933333333333,0,36,36,4,chroma_acts
36,2,16.78933333333333,36.970666666666666,20.181333333333335,36,79,43,4,chroma_acts
36,3,36.970666666666666,77.33333333333333,40.36266666666666,79,165,86,4,chroma_acts
36,4,77.33333333333333,84.37333333333333,7.040000000000006,165,180,15,4,chroma_acts
36,5,84.37333333333333,96.10666666666667,11.733333333333334,180,205,25,4,chroma_acts
36,6,96.10666666666667,126.61333333333333,30.50666666666666,205,270,65,4,chroma_acts
36,7,126.61333333333333,130.368,3.7546666666666653,270,278,8,4,chroma_acts
36,8,130.368,135.53066666666666,5.1626666666666665,278,289,11,4,chroma_acts
36,9,135.53066666666666,187.093,51.56233333333333,289,397,108,4,chroma_acts
37,1,0.0,9.717333333333332,9.717333333333332,0,14,14,4,chroma_acts
37,2,9.717333333333332,74.752,65.03466666666667,14,105,91,4,chroma_acts
37,3,74.752,84.75733333333334,10.00533333333334,105,119,14,4,chroma_acts
37,4,84.75733333333334,90.47466666666666,5.717333333333329,119,127,8,4,chroma_acts
37,5,90.47466666666666,111.91466666666666,21.439999999999998,127,157,30,4,chroma_acts
37,6,111.91466666666666,124.77866666666667,12.864000000000004,157,175,18,4,chroma_acts
37,7,124.77866666666667,136.928,12.149333333333331,175,192,17,4,chroma_acts
37,8,136.928,183.629,46.70099999999999,192,256,64,4,chroma_acts
38,1,0.0,14.677333333333332,14.677333333333332,0,31,31,4,chroma_acts
38,2,14.677333333333332,15.157333333333332,0.4800000000000004,31,32,1,4,chroma_acts
38,3,15.157333333333332,44.91733333333333,29.759999999999998,32,94,62,4,chroma_acts
38,4,44.91733333333333,99.15733333333333,54.239999999999995,94,207,113,4,chroma_acts
38,5,99.15733333333333,106.35733333333333,7.200000000000003,207,222,15,4,chroma_acts
38,6,106.35733333333333,122.19733333333333,15.840000000000003,222,255,33,4,chroma_acts
38,7,122.19733333333333,151.95733333333334,29.760000000000005,255,317,62,4,chroma_acts
38,8,151.95733333333334,185.005,33.04766666666666,317,384,67,4,chroma_acts
40,1,0.0,31.73333333333333,31.73333333333333,0,68,68,5,chroma_acts
40,2,31.73333333333333,58.95466666666667,27.221333333333337,68,126,58,5,chroma_acts
40,3,58.95466666666667,62.24,3.285333333333334,126,133,7,5,chroma_acts
40,4,62.24,90.86933333333333,28.629333333333328,133,194,61,5,chroma_acts
40,5,90.86933333333333,105.41866666666667,14.549333333333337,194,225,31,5,chroma_acts
40,6,105.41866666666667,122.784,17.36533333333334,225,262,37,5,chroma_acts
40,7,122.784,132.17066666666665,9.386666666666642,262,282,20,5,chroma_acts
40,8,132.17066666666665,136.86399999999998,4.693333333333328,282,292,10,5,chroma_acts
40,9,136.86399999999998,181.875,45.011000000000024,292,386,94,5,chroma_acts
41,1,0.0,29.621333333333332,29.621333333333332,0,64,64,4,chroma_acts
41,2,29.621333333333332,74.208,44.586666666666666,64,159,95,4,chroma_acts
41,3,74.208,75.616,1.4080000000000013,159,162,3,4,chroma_acts
41,4,75.616,89.22666666666666,13.61066666666666,162,191,29,4,chroma_acts
41,5,89.22666666666666,100.02133333333333,10.794666666666672,191,214,23,4,chroma_acts
41,6,100.02133333333333,116.91733333333333,16.896,214,250,36,4,chroma_acts
41,7,116.91733333333333,128.18133333333333,11.263999999999996,250,274,24,4,chroma_acts
41,8,128.18133333333333,135.6906666666667,7.509333333333359,274,290,16,4,chroma_acts
41,9,135.6906666666667,166.53,30.839333333333315,290,354,64,4,chroma_acts
43,1,0.0,28.693333333333335,28.693333333333335,0,62,62,4,chroma_acts
43,2,28.693333333333335,60.138666666666666,31.44533333333333,62,129,67,4,chroma_acts
43,3,60.138666666666666,88.768,28.629333333333335,129,190,61,4,chroma_acts
43,4,88.768,105.664,16.896,190,226,36,4,chroma_acts
43,5,105.664,120.68266666666666,15.018666666666661,226,258,32,4,chroma_acts
43,6,120.68266666666666,135.232,14.549333333333337,258,289,31,4,chroma_acts
43,7,135.232,166.079,30.84700000000001,289,353,64,4,chroma_acts
46,1,0.0,6.005333333333334,6.005333333333334,0,13,13,6,chroma_acts
46,2,6.005333333333334,41.333333333333336,35.328,13,85,72,6,chroma_acts
46,3,41.333333333333336,57.03466666666667,15.701333333333338,85,117,32,6,chroma_acts
46,4,57.03466666666667,74.69866666666667,17.663999999999994,117,153,36,6,chroma_acts
46,5,74.69866666666667,107.08266666666667,32.384,153,219,66,6,chroma_acts
46,6,107.08266666666667,124.25600000000001,17.173333333333346,219,254,35,6,chroma_acts
46,7,124.25600000000001,126.70933333333335,2.453333333333333,254,259,5,6,chroma_acts
46,8,126.70933333333335,132.10666666666668,5.397333333333336,259,270,11,6,chroma_acts
46,9,132.10666666666668,168.058,35.95133333333331,270,342,72,6,chroma_acts
48,1,0.0,7.306666666666666,7.306666666666666,0,16,16,4,chroma_acts
48,2,7.306666666666666,26.026666666666664,18.72,16,55,39,4,chroma_acts
48,3,26.026666666666664,44.74666666666667,18.720000000000006,55,94,39,4,chroma_acts
48,4,44.74666666666667,56.74666666666667,12.0,94,119,25,4,chroma_acts
48,5,56.74666666666667,79.30666666666667,22.560000000000002,119,166,47,4,chroma_acts
48,6,79.30666666666667,86.98666666666666,7.679999999999993,166,182,16,4,chroma_acts
48,7,86.98666666666666,117.70666666666666,30.72,182,246,64,4,chroma_acts
48,8,117.70666666666666,153.667,35.96033333333334,246,319,73,4,chroma_acts
51,1,0.0,30.517333333333333,30.517333333333333,0,64,64,3,chroma_acts
51,2,30.517333333333333,59.31733333333333,28.799999999999997,64,124,60,3,chroma_acts
51,3,59.31733333333333,61.23733333333333,1.9200000000000017,124,128,4,3,chroma_acts
51,4,61.23733333333333,91.47733333333333,30.240000000000002,128,191,63,3,chroma_acts
51,5,91.47733333333333,121.23733333333332,29.75999999999999,191,253,62,3,chroma_acts
51,6,121.23733333333332,122.67733333333332,1.4399999999999977,253,256,3,3,chroma_acts
51,7,122.67733333333332,151.95733333333334,29.280000000000015,256,317,61,3,chroma_acts
51,8,151.95733333333334,153.39733333333334,1.4399999999999977,317,320,3,3,chroma_acts
51,9,153.39733333333334,184.32,30.922666666666657,320,383,63,3,chroma_acts
52,1,0.0,4.522666666666667,4.522666666666667,0,10,10,4,chroma_acts
52,2,4.522666666666667,8.362666666666668,3.8400000000000007,10,18,8,4,chroma_acts
52,3,8.362666666666668,12.202666666666667,3.84,18,26,8,4,chroma_acts
52,4,12.202666666666667,15.562666666666667,3.3599999999999994,26,33,7,4,chroma_acts
52,5,15.562666666666667,56.842666666666666,41.28,33,119,86,4,chroma_acts
52,6,56.842666666666666,71.72266666666667,14.880000000000003,119,150,31,4,chroma_acts
52,7,71.72266666666667,88.04266666666668,16.320000000000007,150,184,34,4,chroma_acts
52,8,88.04266666666668,92.84266666666667,4.799999999999997,184,194,10,4,chroma_acts
52,9,92.84266666666667,131.453,38.61033333333333,194,273,79,4,chroma_acts
54,1,0.0,7.8613333333333335,7.8613333333333335,0,17,17,4,chroma_acts
54,2,7.8613333333333335,14.901333333333334,7.04,17,32,15,4,chroma_acts
54,3,14.901333333333334,22.410666666666668,7.509333333333334,32,48,16,4,chroma_acts
54,4,22.410666666666668,44.93866666666666,22.527999999999995,48,96,48,4,chroma_acts
54,5,44.93866666666666,52.44799999999999,7.5093333333333305,96,112,16,4,chroma_acts
54,6,52.44799999999999,95.15733333333334,42.70933333333335,112,203,91,4,chroma_acts
54,7,95.15733333333334,140.68266666666668,45.525333333333336,203,300,97,4,chroma_acts
54,8,140.68266666666668,202.844,62.16133333333332,300,431,131,4,chroma_acts
55,1,0.0,11.178666666666667,11.178666666666667,0,24,24,3,chroma_acts
55,2,11.178666666666667,28.544,17.365333333333332,24,61,37,3,chroma_acts
55,3,28.544,104.576,76.032,61,223,162,3,chroma_acts
55,4,104.576,117.248,12.672000000000011,223,250,27,3,chroma_acts
55,5,117.248,150.10133333333332,32.85333333333331,250,320,70,3,chroma_acts
55,6,150.10133333333332,163.712,13.610666666666674,320,349,29,3,chroma_acts
55,7,163.712,189.99466666666666,26.28266666666667,349,405,56,3,chroma_acts
55,8,189.99466666666666,193.27999999999997,3.2853333333333126,405,412,7,3,chroma_acts
55,9,193.27999999999997,223.669,30.38900000000004,412,475,63,3,chroma_acts
56,1,0.0,14.837333333333333,14.837333333333333,0,32,32,3,chroma_acts
56,2,14.837333333333333,44.87466666666667,30.037333333333336,32,96,64,3,chroma_acts
56,3,44.87466666666667,56.138666666666666,11.263999999999996,96,120,24,3,chroma_acts
56,4,56.138666666666666,59.424,3.285333333333334,120,127,7,3,chroma_acts
56,5,59.424,71.15733333333334,11.733333333333341,127,152,25,3,chroma_acts
56,6,71.15733333333334,97.44,26.282666666666657,152,208,56,3,chroma_acts
56,7,97.44,119.968,22.528000000000006,208,256,48,3,chroma_acts
56,8,119.968,165.306,45.33800000000001,256,351,95,3,chroma_acts
58,1,0.0,31.104,31.104,0,67,67,4,chroma_acts
58,2,31.104,90.24,59.135999999999996,67,193,126,4,chroma_acts
58,3,90.24,137.17333333333332,46.93333333333332,193,293,100,4,chroma_acts
58,4,137.17333333333332,212.26666666666665,75.09333333333333,293,453,160,4,chroma_acts
58,5,212.26666666666665,259.2,46.93333333333334,453,553,100,4,chroma_acts
58,6,259.2,274.21866666666665,15.018666666666661,553,585,32,4,chroma_acts
58,7,274.21866666666665,335.23199999999997,61.01333333333332,585,715,130,4,chroma_acts
58,8,335.23199999999997,365.73866666666663,30.50666666666666,715,780,65,4,chroma_acts
58,9,365.73866666666663,381.109,15.370333333333349,780,811,31,4,chroma_acts
61,1,0.0,14.837333333333333,14.837333333333333,0,32,32,4,chroma_acts
61,2,14.837333333333333,28.917333333333332,14.079999999999998,32,62,30,4,chroma_acts
61,3,28.917333333333332,59.89333333333333,30.976,62,128,66,4,chroma_acts
61,4,59.89333333333333,119.96799999999999,60.07466666666666,128,256,128,4,chroma_acts
61,5,119.96799999999999,147.18933333333334,27.221333333333348,256,314,58,4,chroma_acts
61,6,147.18933333333334,149.536,2.346666666666664,314,319,5,4,chroma_acts
61,7,149.536,153.76000000000002,4.224000000000018,319,328,9,4,chroma_acts
61,8,153.76000000000002,210.08,56.31999999999999,328,448,120,4,chroma_acts
61,9,210.08,240.392,30.311999999999983,448,511,63,4,chroma_acts
64,1,0.0,30.784,30.784,0,65,65,4,chroma_acts
64,2,30.784,35.104,4.32,65,74,9,4,chroma_acts
64,3,35.104,60.544,25.439999999999998,74,127,53,4,chroma_acts
64,4,60.544,139.744,79.2,127,292,165,4,chroma_acts
64,5,139.744,184.38400000000001,44.640000000000015,292,385,93,4,chroma_acts
64,6,184.38400000000001,185.824,1.4399999999999977,385,388,3,4,chroma_acts
64,7,185.824,247.744,61.91999999999999,388,517,129,4,chroma_acts
64,8,247.744,278.926,31.181999999999988,517,580,63,4,chroma_acts
65,1,0.0,16.11733333333333,16.11733333333333,0,34,34,3,chroma_acts
65,2,16.11733333333333,48.757333333333335,32.64,34,102,68,3,chroma_acts
65,3,48.757333333333335,108.75733333333334,60.0,102,227,125,3,chroma_acts
65,4,108.75733333333334,116.43733333333333,7.679999999999993,227,243,16,3,chroma_acts
65,5,116.43733333333333,133.2373333333333,16.799999999999983,243,278,35,3,chroma_acts
65,6,133.2373333333333,136.59733333333332,3.3600000000000136,278,285,7,3,chroma_acts
65,7,136.59733333333332,139.9573333333333,3.359999999999985,285,292,7,3,chroma_acts
65,8,139.9573333333333,150.5173333333333,10.560000000000002,292,314,22,3,chroma_acts
65,9,150.5173333333333,196.5,45.98266666666669,314,408,94,3,chroma_acts
66,1,0.0,28.895999999999997,28.895999999999997,0,61,61,4,chroma_acts
66,2,28.895999999999997,46.175999999999995,17.279999999999998,61,97,36,4,chroma_acts
66,3,46.175999999999995,62.495999999999995,16.32,97,131,34,4,chroma_acts
66,4,62.495999999999995,92.256,29.760000000000005,131,193,62,4,chroma_acts
66,5,92.256,103.296,11.040000000000006,193,216,23,4,chroma_acts
66,6,103.296,107.136,3.839999999999989,216,224,8,4,chroma_acts
66,7,107.136,138.336,31.200000000000017,224,289,65,4,chroma_acts
66,8,138.336,182.496,44.16,289,381,92,4,chroma_acts
66,9,182.496,245.769,63.272999999999996,381,511,130,4,chroma_acts
67,1,0.0,183.43466666666666,183.43466666666666,0,383,383,3,chroma_acts
67,2,183.43466666666666,199.75466666666665,16.319999999999993,383,417,34,3,chroma_acts
67,3,199.75466666666665,245.83466666666666,46.08000000000001,417,513,96,3,chroma_acts
67,4,245.83466666666666,261.19466666666665,15.359999999999985,513,545,32,3,chroma_acts
67,5,261.19466666666665,288.07466666666664,26.879999999999995,545,601,56,3,chroma_acts
67,6,288.07466666666664,291.43466666666666,3.3600000000000136,601,608,7,3,chroma_acts
67,7,291.43466666666666,322.63466666666665,31.19999999999999,608,673,65,3,chroma_acts
67,8,322.63466666666665,358.856,36.22133333333335,673,747,74,3,chroma_acts
68,1,0.0,4.2986666666666675,4.2986666666666675,0,8,8,4,chroma_acts
68,2,4.2986666666666675,54.47466666666667,50.176,8,92,84,4,chroma_acts
68,3,54.47466666666667,76.57600000000001,22.101333333333336,92,129,37,4,chroma_acts
68,4,76.57600000000001,147.06133333333335,70.48533333333334,129,247,118,4,chroma_acts
68,5,147.06133333333335,154.82666666666668,7.765333333333331,247,260,13,4,chroma_acts
68,6,154.82666666666668,162.592,7.765333333333331,260,273,13,4,chroma_acts
68,7,162.592,166.17600000000002,3.584000000000003,273,279,6,4,chroma_acts
68,8,166.17600000000002,181.70666666666668,15.530666666666662,279,305,26,4,chroma_acts
68,9,181.70666666666668,219.967,38.260333333333335,305,368,63,4,chroma_acts
69,1,0.0,17.461333333333332,17.461333333333332,0,37,37,5,chroma_acts
69,2,17.461333333333332,26.101333333333333,8.64,37,55,18,5,chroma_acts
69,3,26.101333333333333,34.74133333333334,8.640000000000004,55,73,18,5,chroma_acts
69,4,34.74133333333334,64.02133333333333,29.279999999999994,73,134,61,5,chroma_acts
69,5,64.02133333333333,80.82133333333333,16.799999999999997,134,169,35,5,chroma_acts
69,6,80.82133333333333,111.06133333333332,30.239999999999995,169,232,63,5,chroma_acts
69,7,111.06133333333332,156.18133333333333,45.120000000000005,232,326,94,5,chroma_acts
69,8,156.18133333333333,164.82133333333334,8.640000000000015,326,344,18,5,chroma_acts
69,9,164.82133333333334,205.043,40.221666666666664,344,426,82,5,chroma_acts
70,1,0.0,5.685333333333333,5.685333333333333,0,12,12,5,chroma_acts
70,2,5.685333333333333,30.165333333333333,24.48,12,63,51,5,chroma_acts
70,3,30.165333333333333,58.965333333333334,28.8,63,123,60,5,chroma_acts
70,4,58.965333333333334,75.76533333333333,16.799999999999997,123,158,35,5,chroma_acts
70,5,75.76533333333333,106.48533333333333,30.72,158,222,64,5,chroma_acts
70,6,106.48533333333333,121.84533333333333,15.36,222,254,32,5,chroma_acts
70,7,121.84533333333333,138.64533333333333,16.799999999999997,254,289,35,5,chroma_acts
70,8,138.64533333333333,183.397,44.751666666666665,289,381,92,5,chroma_acts
71,1,0.0,8.768,8.768,0,19,19,4,chroma_acts
71,2,8.768,51.488,42.72,19,108,89,4,chroma_acts
71,3,51.488,60.128,8.64,108,126,18,4,chroma_acts
71,4,60.128,122.52799999999999,62.39999999999999,126,256,130,4,chroma_acts
71,5,122.52799999999999,130.688,8.159999999999997,256,273,17,4,chroma_acts
71,6,130.688,134.528,3.8400000000000034,273,281,8,4,chroma_acts
71,7,134.528,154.208,19.680000000000007,281,322,41,4,chroma_acts
71,8,154.208,215.648,61.44,322,450,128,4,chroma_acts
71,9,215.648,264.996,49.347999999999985,450,551,101,4,chroma_acts
72,1,0.0,7.018666666666666,7.018666666666666,0,15,15,4,chroma_acts
72,2,7.018666666666666,37.73866666666667,30.72,15,79,64,4,chroma_acts
72,3,37.73866666666667,45.41866666666667,7.68,79,95,16,4,chroma_acts
72,4,45.41866666666667,51.178666666666665,5.759999999999998,95,107,12,4,chroma_acts
72,5,51.178666666666665,83.33866666666665,32.15999999999999,107,174,67,4,chroma_acts
72,6,83.33866666666665,114.05866666666665,30.72,174,238,64,4,chroma_acts
72,7,114.05866666666665,129.41866666666667,15.360000000000014,238,270,32,4,chroma_acts
72,8,129.41866666666667,167.33866666666665,37.91999999999999,270,349,79,4,chroma_acts
72,9,167.33866666666665,175.856,8.51733333333334,349,365,16,4,chroma_acts
73,1,0.0,15.424,15.424,0,33,33,4,chroma_acts
73,2,15.424,61.983999999999995,46.559999999999995,33,130,97,4,chroma_acts
73,3,61.983999999999995,123.904,61.92,130,259,129,4,chroma_acts
73,4,123.904,168.544,44.640000000000015,259,352,93,4,chroma_acts
73,5,168.544,172.38400000000001,3.8400000000000034,352,360,8,4,chroma_acts
73,6,172.38400000000001,176.704,4.319999999999993,360,369,9,4,chroma_acts
73,7,176.704,180.064,3.359999999999985,369,376,7,4,chroma_acts
73,8,180.064,185.824,5.760000000000019,376,388,12,4,chroma_acts
73,9,185.824,263.263,77.43899999999996,388,548,160,4,chroma_acts
75,1,0.0,12.277333333333333,12.277333333333333,0,27,27,4,chroma_acts
75,2,12.277333333333333,43.72266666666666,31.44533333333333,27,94,67,4,chroma_acts
75,3,43.72266666666666,59.67999999999999,15.957333333333331,94,128,34,4,chroma_acts
75,4,59.67999999999999,89.71733333333333,30.037333333333336,128,192,64,4,chroma_acts
75,5,89.71733333333333,119.75466666666667,30.037333333333336,192,256,64,4,chroma_acts
75,6,119.75466666666667,154.01600000000002,34.261333333333354,256,329,73,4,chroma_acts
75,7,154.01600000000002,180.29866666666666,26.282666666666643,329,385,56,4,chroma_acts
75,8,180.29866666666666,194.848,14.549333333333351,385,416,31,4,chroma_acts
75,9,194.848,225.489,30.64099999999999,416,480,64,4,chroma_acts
76,1,0.0,7.946666666666666,7.946666666666666,0,17,17,4,chroma_acts
76,2,7.946666666666666,42.026666666666664,34.08,17,88,71,4,chroma_acts
76,3,42.026666666666664,96.26666666666667,54.24,88,201,113,4,chroma_acts
76,4,96.26666666666667,130.34666666666666,34.08,201,272,71,4,chroma_acts
76,5,130.34666666666666,161.54666666666668,31.200000000000017,272,337,65,4,chroma_acts
76,6,161.54666666666668,212.42666666666668,50.879999999999995,337,443,106,4,chroma_acts
76,7,212.42666666666668,222.50666666666666,10.079999999999984,443,464,21,4,chroma_acts
76,8,222.50666666666666,253.22666666666666,30.72,464,528,64,4,chroma_acts
76,9,253.22666666666666,269.16,15.933333333333366,528,560,32,4,chroma_acts
78,1,0.0,16.821333333333335,16.821333333333335,0,36,36,5,chroma_acts
78,2,16.821333333333335,60.501333333333335,43.68,36,127,91,5,chroma_acts
78,3,60.501333333333335,91.22133333333333,30.72,127,191,64,5,chroma_acts
78,4,91.22133333333333,106.10133333333333,14.879999999999995,191,222,31,5,chroma_acts
78,5,106.10133333333333,151.7013333333333,45.59999999999998,222,317,95,5,chroma_acts
78,6,151.7013333333333,167.06133333333332,15.360000000000014,317,349,32,5,chroma_acts
78,7,167.06133333333332,197.78133333333332,30.72,349,413,64,5,chroma_acts
78,8,197.78133333333332,258.2613333333333,60.47999999999999,413,539,126,5,chroma_acts
78,9,258.2613333333333,289.524,31.26266666666669,539,603,64,5,chroma_acts
79,1,0.0,11.562666666666665,11.562666666666665,0,25,25,4,chroma_acts
79,2,11.562666666666665,57.64266666666666,46.08,25,121,96,4,chroma_acts
79,3,57.64266666666666,103.72266666666667,46.080000000000005,121,217,96,4,chroma_acts
79,4,103.72266666666667,117.16266666666667,13.439999999999998,217,245,28,4,chroma_acts
79,5,117.16266666666667,119.08266666666667,1.9200000000000017,245,249,4,4,chroma_acts
79,6,119.08266666666667,145.96266666666668,26.88000000000001,249,305,56,4,chroma_acts
79,7,145.96266666666668,150.28266666666667,4.319999999999993,305,314,9,4,chroma_acts
79,8,150.28266666666667,180.884,30.601333333333315,314,376,62,4,chroma_acts
82,1,0.0,14.975999999999999,14.975999999999999,0,32,32,4,chroma_acts
82,2,14.975999999999999,61.535999999999994,46.559999999999995,32,129,97,4,chroma_acts
82,3,61.535999999999994,91.776,30.240000000000002,129,192,63,4,chroma_acts
82,4,91.776,137.856,46.08,192,288,96,4,chroma_acts
82,5,137.856,143.61599999999999,5.759999999999991,288,300,12,4,chroma_acts
82,6,143.61599999999999,176.736,33.120000000000005,300,369,69,4,chroma_acts
82,7,176.736,230.49599999999998,53.75999999999999,369,481,112,4,chroma_acts
82,8,230.49599999999998,262.671,32.17500000000001,481,547,66,4,chroma_acts
83,1,0.0,52.831999999999994,52.831999999999994,0,111,111,4,chroma_acts
83,2,52.831999999999994,69.152,16.320000000000007,111,145,34,4,chroma_acts
83,3,69.152,98.432,29.28,145,206,61,4,chroma_acts
83,4,98.432,114.752,16.319999999999993,206,240,34,4,chroma_acts
83,5,114.752,191.07199999999997,76.31999999999998,240,399,159,4,chroma_acts
83,6,191.07199999999997,220.35199999999998,29.28,399,460,61,4,chroma_acts
83,7,220.35199999999998,238.112,17.76000000000002,460,497,37,4,chroma_acts
83,8,238.112,250.525,12.413000000000011,497,521,24,4,chroma_acts
86,1,0.0,7.690666666666667,7.690666666666667,0,17,17,5,chroma_acts
86,2,7.690666666666667,58.848,51.157333333333334,17,126,109,5,chroma_acts
86,3,58.848,89.35466666666666,30.50666666666666,126,191,65,5,chroma_acts
86,4,89.35466666666666,94.04799999999999,4.693333333333328,191,201,10,5,chroma_acts
86,5,94.04799999999999,96.86399999999999,2.8160000000000025,201,207,6,5,chroma_acts
86,6,96.86399999999999,139.10399999999998,42.239999999999995,207,297,90,5,chroma_acts
86,7,139.10399999999998,150.368,11.26400000000001,297,321,24,5,chroma_acts
86,8,150.368,158.816,8.448000000000008,321,339,18,5,chroma_acts
86,9,158.816,197.663,38.84700000000001,339,420,81,5,chroma_acts
88,1,0.0,11.52,11.52,0,25,25,3,chroma_acts
88,2,11.52,14.805333333333333,3.285333333333334,25,32,7,3,chroma_acts
88,3,14.805333333333333,30.293333333333333,15.488,32,65,33,3,chroma_acts
88,4,30.293333333333333,44.842666666666666,14.549333333333333,65,96,31,3,chroma_acts
88,5,44.842666666666666,73.472,28.629333333333328,96,157,61,3,chroma_acts
88,6,73.472,104.91733333333333,31.445333333333338,157,224,67,3,chroma_acts
88,7,104.91733333333333,120.40533333333333,15.488,224,257,33,3,chroma_acts
88,8,120.40533333333333,149.504,29.09866666666666,257,319,62,3,chroma_acts
88,9,149.504,180.275,30.771000000000015,319,383,64,3,chroma_acts
89,1,0.0,29.077333333333332,29.077333333333332,0,61,61,3,chroma_acts
89,2,29.077333333333332,30.997333333333334,1.9200000000000017,61,65,4,3,chroma_acts
89,3,30.997333333333334,45.87733333333333,14.879999999999999,65,96,31,3,chroma_acts
89,4,45.87733333333333,61.23733333333333,15.36,96,128,32,3,chroma_acts
89,5,61.23733333333333,90.51733333333333,29.279999999999994,128,189,61,3,chroma_acts
89,6,90.51733333333333,139.95733333333334,49.44000000000001,189,292,103,3,chroma_acts
89,7,139.95733333333334,186.03733333333332,46.079999999999984,292,388,96,3,chroma_acts
89,8,186.03733333333332,203.53,17.49266666666668,388,423,35,3,chroma_acts
90,1,0.0,6.826666666666666,6.826666666666666,0,15,15,5,chroma_acts
90,2,6.826666666666666,21.226666666666663,14.399999999999997,15,45,30,5,chroma_acts
90,3,21.226666666666663,28.426666666666666,7.200000000000003,45,60,15,5,chroma_acts
90,4,28.426666666666666,36.10666666666667,7.680000000000003,60,76,16,5,chroma_acts
90,5,36.10666666666667,67.78666666666666,31.679999999999993,76,142,66,5,chroma_acts
90,6,67.78666666666666,97.06666666666666,29.28,142,203,61,5,chroma_acts
90,7,97.06666666666666,118.66666666666667,21.60000000000001,203,248,45,5,chroma_acts
90,8,118.66666666666667,125.86666666666666,7.199999999999989,248,263,15,5,chroma_acts
90,9,125.86666666666666,174.549,48.68233333333335,263,363,100,5,chroma_acts
91,1,0.0,17.311999999999998,17.311999999999998,0,37,37,5,chroma_acts
91,2,17.311999999999998,24.991999999999997,7.68,37,53,16,5,chroma_acts
91,3,24.991999999999997,32.192,7.200000000000003,53,68,15,5,chroma_acts
91,4,32.192,60.51199999999999,28.319999999999993,68,127,59,5,chroma_acts
91,5,60.51199999999999,93.152,32.64000000000001,127,195,68,5,chroma_acts
91,6,93.152,101.312,8.159999999999997,195,212,17,5,chroma_acts
91,7,101.312,105.152,3.8400000000000034,212,220,8,5,chroma_acts
91,8,105.152,108.512,3.3599999999999994,220,227,7,5,chroma_acts
91,9,108.512,154.286,45.774,227,321,94,5,chroma_acts
92,1,0.0,37.215999999999994,37.215999999999994,0,82,82,5,chroma_acts
92,2,37.215999999999994,99.59466666666665,62.37866666666666,82,218,136,5,chroma_acts
92,3,99.59466666666665,113.81333333333332,14.218666666666664,218,249,31,5,chroma_acts
92,4,113.81333333333332,117.48266666666665,3.669333333333327,249,257,8,5,chroma_acts
92,5,117.48266666666665,150.048,32.565333333333356,257,328,71,5,chroma_acts
92,6,150.048,164.72533333333334,14.677333333333337,328,360,32,5,chroma_acts
92,7,164.72533333333334,178.02666666666667,13.301333333333332,360,389,29,5,chroma_acts
92,8,178.02666666666667,189.03466666666665,11.007999999999981,389,413,24,5,chroma_acts
92,9,189.03466666666665,241.838,52.80333333333334,413,527,114,5,chroma_acts
93,1,0.0,17.493333333333332,17.493333333333332,0,38,38,4,chroma_acts
93,2,17.493333333333332,33.92,16.42666666666667,38,73,35,4,chroma_acts
93,3,33.92,64.896,30.976,73,139,66,4,chroma_acts
93,4,64.896,85.07733333333333,20.181333333333328,139,182,43,4,chroma_acts
93,5,85.07733333333333,105.25866666666667,20.181333333333342,182,225,43,4,chroma_acts
93,6,105.25866666666667,135.296,30.037333333333322,225,289,64,4,chroma_acts
93,7,135.296,151.875,16.579000000000008,289,323,34,4,chroma_acts
95,1,0.0,6.1226666666666665,6.1226666666666665,0,14,14,4,chroma_acts
95,2,6.1226666666666665,9.877333333333333,3.754666666666666,14,22,8,4,chroma_acts
95,3,9.877333333333333,13.632,3.754666666666667,22,30,8,4,chroma_acts
95,4,13.632,17.386666666666667,3.754666666666667,30,38,8,4,chroma_acts
95,5,17.386666666666667,47.424,30.037333333333333,38,102,64,4,chroma_acts
95,6,47.424,76.99199999999999,29.56799999999999,102,165,63,4,chroma_acts
95,7,76.99199999999999,120.17066666666666,43.17866666666667,165,257,92,4,chroma_acts
95,8,120.17066666666666,137.06666666666666,16.896,257,293,36,4,chroma_acts
95,9,137.06666666666666,184.291,47.224333333333334,293,392,99,4,chroma_acts
98,1,0.0,9.674666666666667,9.674666666666667,0,21,21,4,chroma_acts
98,2,9.674666666666667,25.162666666666667,15.488,21,54,33,4,chroma_acts
98,3,25.162666666666667,40.18133333333333,15.018666666666661,54,86,32,4,chroma_acts
98,4,40.18133333333333,67.872,27.690666666666672,86,145,59,4,chroma_acts
98,5,67.872,100.72533333333332,32.853333333333325,145,215,70,4,chroma_acts
98,6,100.72533333333332,131.232,30.506666666666675,215,280,65,4,chroma_acts
98,7,131.232,144.37333333333333,13.141333333333336,280,308,28,4,chroma_acts
98,8,144.37333333333333,161.26933333333335,16.896000000000015,308,344,36,4,chroma_acts
98,9,161.26933333333335,206.745,45.475666666666655,344,439,95,4,chroma_acts
99,1,0.0,14.431999999999999,14.431999999999999,0,31,31,4,chroma_acts
99,2,14.431999999999999,30.272,15.84,31,64,33,4,chroma_acts
99,3,30.272,59.071999999999996,28.799999999999997,64,124,60,4,chroma_acts
99,4,59.071999999999996,75.872,16.800000000000004,124,159,35,4,chroma_acts
99,5,75.872,104.672,28.799999999999997,159,219,60,4,chroma_acts
99,6,104.672,121.952,17.28,219,255,36,4,chroma_acts
99,7,121.952,136.35199999999998,14.399999999999977,255,285,30,4,chroma_acts
99,8,136.35199999999998,152.19199999999998,15.840000000000003,285,318,33,4,chroma_acts
99,9,152.19199999999998,184.762,32.57000000000002,318,384,66,4,chroma_acts
101,1,0.0,10.570666666666666,10.570666666666666,0,21,21,5,chroma_acts
101,2,10.570666666666666,95.24266666666666,84.672,21,183,162,5,chroma_acts
101,3,95.24266666666666,97.33333333333333,2.090666666666664,183,187,4,5,chroma_acts
101,4,97.33333333333333,114.05866666666665,16.725333333333325,187,219,32,5,chroma_acts
101,5,114.05866666666665,132.35199999999998,18.293333333333322,219,254,35,5,chroma_acts
101,6,132.35199999999998,182.528,50.176000000000016,254,350,96,5,chroma_acts
101,7,182.528,187.23199999999997,4.703999999999979,350,359,9,5,chroma_acts
101,8,187.23199999999997,194.592,7.360000000000042,359,372,13,5,chroma_acts
102,1,0.0,46.35733333333333,46.35733333333333,0,97,97,5,chroma_acts
102,2,46.35733333333333,54.03733333333333,7.68,97,113,16,5,chroma_acts
102,3,54.03733333333333,84.75733333333332,30.71999999999999,113,177,64,5,chroma_acts
102,4,84.75733333333332,107.79733333333333,23.040000000000006,177,225,48,5,chroma_acts
102,5,107.79733333333333,157.23733333333334,49.44000000000001,225,328,103,5,chroma_acts
102,6,157.23733333333334,176.43733333333333,19.19999999999999,328,368,40,5,chroma_acts
102,7,176.43733333333333,184.59733333333332,8.159999999999997,368,385,17,5,chroma_acts
102,8,184.59733333333332,192.27733333333333,7.680000000000007,385,401,16,5,chroma_acts
102,9,192.27733333333333,238.584,46.30666666666667,401,496,95,5,chroma_acts
103,1,0.0,18.293333333333333,18.293333333333333,0,39,39,4,chroma_acts
103,2,18.293333333333333,24.05333333333333,5.759999999999998,39,51,12,4,chroma_acts
103,3,24.05333333333333,31.73333333333333,7.68,51,67,16,4,chroma_acts
103,4,31.73333333333333,46.61333333333334,14.880000000000006,67,98,31,4,chroma_acts
103,5,46.61333333333334,109.01333333333334,62.4,98,228,130,4,chroma_acts
103,6,109.01333333333334,147.89333333333332,38.87999999999998,228,309,81,4,chroma_acts
103,7,147.89333333333332,230.334,82.44066666666669,309,479,170,4,chroma_acts
104,1,0.0,72.56533333333333,72.56533333333333,0,152,152,5,chroma_acts
104,2,72.56533333333333,91.76533333333333,19.200000000000003,152,192,40,5,chroma_acts
104,3,91.76533333333333,95.60533333333332,3.839999999999989,192,200,8,5,chroma_acts
104,4,95.60533333333332,109.04533333333332,13.439999999999998,200,228,28,5,chroma_acts
104,5,109.04533333333332,164.72533333333334,55.68000000000002,228,344,116,5,chroma_acts
104,6,164.72533333333334,182.96533333333335,18.24000000000001,344,382,38,5,chroma_acts
104,7,182.96533333333335,187.76533333333333,4.799999999999983,382,392,10,5,chroma_acts
104,8,187.76533333333333,198.32533333333333,10.560000000000002,392,414,22,5,chroma_acts
104,9,198.32533333333333,206.999,8.673666666666662,414,431,17,5,chroma_acts
105,1,0.0,49.141333333333336,49.141333333333336,0,93,93,4,chroma_acts
105,2,49.141333333333336,55.541333333333334,6.399999999999999,93,105,12,4,chroma_acts
105,3,55.541333333333334,68.34133333333332,12.79999999999999,105,129,24,4,chroma_acts
105,4,68.34133333333332,120.07466666666667,51.73333333333335,129,226,97,4,chroma_acts
105,5,120.07466666666667,135.00799999999998,14.933333333333309,226,254,28,4,chroma_acts
105,6,135.00799999999998,154.208,19.200000000000017,254,290,36,4,chroma_acts
105,7,154.208,188.34133333333332,34.133333333333326,290,354,64,4,chroma_acts
105,8,188.34133333333332,207.447,19.10566666666668,354,388,34,4,chroma_acts
106,1,0.0,9.397333333333334,9.397333333333334,0,20,20,6,chroma_acts
106,2,9.397333333333334,13.237333333333334,3.84,20,28,8,6,chroma_acts
106,3,13.237333333333334,32.437333333333335,19.200000000000003,28,68,40,6,chroma_acts
106,4,32.437333333333335,78.51733333333333,46.07999999999999,68,164,96,6,chroma_acts
106,5,78.51733333333333,86.67733333333334,8.16000000000001,164,181,17,6,chroma_acts
106,6,86.67733333333334,90.51733333333333,3.839999999999989,181,189,8,6,chroma_acts
106,7,90.51733333333333,109.23733333333332,18.72,189,228,39,6,chroma_acts
106,8,109.23733333333332,141.675,32.437666666666686,228,294,66,6,chroma_acts
107,1,0.0,27.712,27.712,0,60,60,5,chroma_acts
107,2,27.712,75.11466666666666,47.40266666666666,60,161,101,5,chroma_acts
107,3,75.11466666666666,122.98666666666666,47.872,161,263,102,5,chroma_acts
107,4,122.98666666666666,125.80266666666667,2.8160000000000025,263,269,6,5,chroma_acts
107,5,125.80266666666667,132.84266666666667,7.040000000000006,269,284,15,5,chroma_acts
107,6,132.84266666666667,144.10666666666665,11.263999999999982,284,308,24,5,chroma_acts
107,7,144.10666666666665,152.55466666666666,8.448000000000008,308,326,18,5,chroma_acts
107,8,152.55466666666666,165.696,13.141333333333336,326,354,28,5,chroma_acts
107,9,165.696,212.086,46.390000000000015,354,451,97,5,chroma_acts
108,1,0.0,45.888,45.888,0,96,96,5,chroma_acts
108,2,45.888,91.488,45.6,96,191,95,5,chroma_acts
108,3,91.488,137.568,46.08000000000001,191,287,96,5,chroma_acts
108,4,137.568,152.448,14.879999999999995,287,318,31,5,chroma_acts
108,5,152.448,183.168,30.72,318,382,64,5,chroma_acts
108,6,183.168,213.888,30.72,382,446,64,5,chroma_acts
108,7,213.888,243.648,29.75999999999999,446,508,62,5,chroma_acts
108,8,243.648,305.088,61.440000000000026,508,636,128,5,chroma_acts
108,9,305.088,336.665,31.576999999999998,636,700,64,5,chroma_acts
109,1,0.0,15.264,15.264,0,33,33,3,chroma_acts
109,2,15.264,32.16,16.895999999999997,33,69,36,3,chroma_acts
109,3,32.16,59.38133333333333,27.221333333333334,69,127,58,3,chroma_acts
109,4,59.38133333333333,62.19733333333333,2.8160000000000025,127,133,6,3,chroma_acts
109,5,62.19733333333333,121.33333333333334,59.13600000000001,133,259,126,3,chroma_acts
109,6,121.33333333333334,135.88266666666667,14.549333333333323,259,290,31,3,chroma_acts
109,7,135.88266666666667,147.14666666666668,11.26400000000001,290,314,24,3,chroma_acts
109,8,147.14666666666668,152.77866666666665,5.631999999999977,314,326,12,3,chroma_acts
109,9,152.77866666666665,212.139,59.36033333333336,326,451,125,3,chroma_acts
114,1,0.0,16.59733333333333,16.59733333333333,0,36,36,4,chroma_acts
114,2,16.59733333333333,61.653333333333336,45.056000000000004,36,132,96,4,chroma_acts
114,3,61.653333333333336,75.73333333333333,14.079999999999998,132,162,30,4,chroma_acts
114,4,75.73333333333333,107.17866666666667,31.445333333333338,162,229,67,4,chroma_acts
114,5,107.17866666666667,135.33866666666665,28.159999999999982,229,289,60,4,chroma_acts
114,6,135.33866666666665,175.7013333333333,40.362666666666655,289,375,86,4,chroma_acts
114,7,175.7013333333333,186.02666666666664,10.325333333333333,375,397,22,4,chroma_acts
114,8,186.02666666666664,198.066,12.03933333333336,397,421,24,4,chroma_acts
115,1,0.0,16.256,16.256,0,32,32,5,chroma_acts
115,2,16.256,34.688,18.432000000000002,32,68,36,5,chroma_acts
115,3,34.688,80.768,46.08,68,158,90,5,chroma_acts
115,4,80.768,99.712,18.944000000000003,158,195,37,5,chroma_acts
115,5,99.712,134.016,34.30399999999999,195,262,67,5,chroma_acts
115,6,134.016,180.60799999999998,46.591999999999985,262,353,91,5,chroma_acts
115,7,180.60799999999998,182.14399999999998,1.5360000000000014,353,356,3,5,chroma_acts
115,8,182.14399999999998,188.28799999999998,6.1440000000000055,356,368,12,5,chroma_acts
115,9,188.28799999999998,215.301,27.013000000000005,368,419,51,5,chroma_acts
116,1,0.0,39.01866666666667,39.01866666666667,0,77,77,4,chroma_acts
116,2,39.01866666666667,42.09066666666667,3.0720000000000027,77,83,6,4,chroma_acts
116,3,42.09066666666667,46.69866666666667,4.607999999999997,83,92,9,4,chroma_acts
116,4,46.69866666666667,50.28266666666667,3.584000000000003,92,99,7,4,chroma_acts
116,5,50.28266666666667,54.89066666666667,4.607999999999997,99,108,9,4,chroma_acts
116,6,54.89066666666667,58.47466666666667,3.584000000000003,108,115,7,4,chroma_acts
116,7,58.47466666666667,63.08266666666667,4.607999999999997,115,124,9,4,chroma_acts
116,8,63.08266666666667,144.49066666666667,81.408,124,283,159,4,chroma_acts
116,9,144.49066666666667,208.974,64.48333333333332,283,407,124,4,chroma_acts
118,1,0.0,37.973333333333336,37.973333333333336,0,85,85,4,chroma_acts
118,2,37.973333333333336,41.55733333333334,3.584000000000003,85,93,8,4,chroma_acts
118,3,41.55733333333334,88.14933333333335,46.592000000000006,93,197,104,4,chroma_acts
118,4,88.14933333333335,103.38133333333336,15.232000000000014,197,231,34,4,chroma_acts
118,5,103.38133333333336,117.26933333333335,13.887999999999991,231,262,31,4,chroma_acts
118,6,117.26933333333335,120.85333333333335,3.584000000000003,262,270,8,4,chroma_acts
118,7,120.85333333333335,124.43733333333336,3.584000000000003,270,278,8,4,chroma_acts
118,8,124.43733333333336,128.02133333333336,3.584000000000003,278,286,8,4,chroma_acts
118,9,128.02133333333336,189.994,61.97266666666664,286,423,137,4,chroma_acts
127,1,0.0,31.989333333333335,31.989333333333335,0,67,67,5,chroma_acts
127,2,31.989333333333335,64.62933333333334,32.64,67,135,68,5,chroma_acts
127,3,64.62933333333334,110.22933333333333,45.599999999999994,135,230,95,5,chroma_acts
127,4,110.22933333333333,118.38933333333333,8.159999999999997,230,247,17,5,chroma_acts
127,5,118.38933333333333,126.06933333333333,7.680000000000007,247,263,16,5,chroma_acts
127,6,126.06933333333333,133.26933333333335,7.200000000000017,263,278,15,5,chroma_acts
127,7,133.26933333333335,140.94933333333333,7.679999999999978,278,294,16,5,chroma_acts
127,8,140.94933333333333,175.02933333333334,34.08000000000001,294,365,71,5,chroma_acts
127,9,175.02933333333334,217.39,42.360666666666646,365,452,87,5,chroma_acts
129,1,0.0,10.815999999999999,10.815999999999999,0,24,24,5,chroma_acts
129,2,10.815999999999999,44.29866666666666,33.48266666666666,24,97,73,5,chroma_acts
129,3,44.29866666666666,74.57066666666665,30.27199999999999,97,163,66,5,chroma_acts
129,4,74.57066666666665,103.46666666666665,28.896,163,226,63,5,chroma_acts
129,5,103.46666666666665,118.14399999999999,14.677333333333337,226,258,32,5,chroma_acts
129,6,118.14399999999999,127.77599999999998,9.63199999999999,258,279,21,5,chroma_acts
129,7,127.77599999999998,132.82133333333334,5.04533333333336,279,290,11,5,chroma_acts
129,8,132.82133333333334,186.273,53.451666666666654,290,405,115,5,chroma_acts
130,1,0.0,12.426666666666666,12.426666666666666,0,26,26,5,chroma_acts
130,2,12.426666666666666,30.666666666666664,18.24,26,64,38,5,chroma_acts
130,3,30.666666666666664,59.946666666666665,29.28,64,125,61,5,chroma_acts
130,4,59.946666666666665,109.38666666666666,49.43999999999999,125,228,103,5,chroma_acts
130,5,109.38666666666666,148.74666666666667,39.360000000000014,228,310,82,5,chroma_acts
130,6,148.74666666666667,153.54666666666668,4.800000000000011,310,320,10,5,chroma_acts
130,7,153.54666666666668,214.98666666666668,61.44,320,448,128,5,chroma_acts
130,8,214.98666666666668,234.211,19.224333333333334,448,487,39,5,chroma_acts
131,1,0.0,60.831999999999994,60.831999999999994,0,127,127,5,chroma_acts
131,2,60.831999999999994,93.472,32.64,127,195,68,5,chroma_acts
131,3,93.472,128.512,35.040000000000006,195,268,73,5,chroma_acts
131,4,128.512,132.352,3.8400000000000034,268,276,8,5,chroma_acts
131,5,132.352,138.112,5.759999999999991,276,288,12,5,chroma_acts
131,6,138.112,143.87199999999999,5.759999999999991,288,300,12,5,chroma_acts
131,7,143.87199999999999,147.712,3.8400000000000034,300,308,8,5,chroma_acts
131,8,147.712,155.392,7.680000000000007,308,324,16,5,chroma_acts
131,9,155.392,202.741,47.34900000000002,324,421,97,5,chroma_acts
132,1,0.0,28.661333333333335,28.661333333333335,0,60,60,4,chroma_acts
132,2,28.661333333333335,45.94133333333333,17.279999999999998,60,96,36,4,chroma_acts
132,3,45.94133333333333,76.18133333333334,30.24000000000001,96,159,63,4,chroma_acts
132,4,76.18133333333334,122.26133333333334,46.08,159,255,96,4,chroma_acts
132,5,122.26133333333334,125.62133333333334,3.3599999999999994,255,262,7,4,chroma_acts
132,6,125.62133333333334,129.94133333333332,4.319999999999979,262,271,9,4,chroma_acts
132,7,129.94133333333332,137.1413333333333,7.199999999999989,271,286,15,4,chroma_acts
132,8,137.1413333333333,146.74133333333333,9.600000000000023,286,306,20,4,chroma_acts
132,9,146.74133333333333,230.609,83.86766666666668,306,479,173,4,chroma_acts
135,1,0.0,15.946666666666665,15.946666666666665,0,35,35,6,chroma_acts
135,2,15.946666666666665,37.504,21.557333333333332,35,82,47,6,chroma_acts
135,3,37.504,46.67733333333333,9.173333333333332,82,102,20,6,chroma_acts
135,4,46.67733333333333,78.32533333333333,31.648000000000003,102,171,69,6,chroma_acts
135,5,78.32533333333333,91.16799999999999,12.84266666666666,171,199,28,6,chroma_acts
135,6,91.16799999999999,126.48533333333332,35.31733333333332,199,276,77,6,chroma_acts
135,7,126.48533333333332,135.19999999999996,8.714666666666645,276,295,19,6,chroma_acts
135,8,135.19999999999996,168.633,33.43300000000005,295,366,71,6,chroma_acts
138,1,0.0,8.725333333333333,8.725333333333333,0,19,19,4,chroma_acts
138,2,8.725333333333333,14.826666666666666,6.101333333333333,19,32,13,4,chroma_acts
138,3,14.826666666666666,25.152,10.325333333333335,32,54,22,4,chroma_acts
138,4,25.152,29.845333333333333,4.693333333333332,54,64,10,4,chroma_acts
138,5,29.845333333333333,73.024,43.17866666666667,64,156,92,4,chroma_acts
138,6,73.024,81.472,8.447999999999993,156,174,18,4,chroma_acts
138,7,81.472,88.98133333333332,7.5093333333333305,174,190,16,4,chroma_acts
138,8,88.98133333333332,141.54666666666665,52.56533333333333,190,302,112,4,chroma_acts
138,9,141.54666666666665,157.475,15.928333333333342,302,334,32,4,chroma_acts
139,1,0.0,7.029333333333333,7.029333333333333,0,15,15,4,chroma_acts
139,2,7.029333333333333,21.429333333333332,14.399999999999999,15,45,30,4,chroma_acts
139,3,21.429333333333332,27.669333333333334,6.240000000000002,45,58,13,4,chroma_acts
139,4,27.669333333333334,38.70933333333333,11.04,58,81,23,4,chroma_acts
139,5,38.70933333333333,84.78933333333332,46.079999999999984,81,177,96,4,chroma_acts
139,6,84.78933333333332,92.94933333333333,8.16000000000001,177,194,17,4,chroma_acts
139,7,92.94933333333333,122.22933333333333,29.28,194,255,61,4,chroma_acts
139,8,122.22933333333333,165.391,43.16166666666666,255,343,88,4,chroma_acts
140,1,0.0,14.613333333333335,14.613333333333335,0,21,21,5,chroma_acts
140,2,14.613333333333335,16.789333333333335,2.176,21,24,3,5,chroma_acts
140,3,16.789333333333335,49.42933333333334,32.64,24,69,45,5,chroma_acts
140,4,49.42933333333334,76.992,27.562666666666665,69,107,38,5,chroma_acts
140,5,76.992,94.4,17.408,107,131,24,5,chroma_acts
140,6,94.4,119.06133333333334,24.66133333333333,131,165,34,5,chroma_acts
140,7,119.06133333333334,152.477,33.41566666666667,165,210,45,5,chroma_acts
141,1,0.0,19.242666666666665,19.242666666666665,0,41,41,5,chroma_acts
141,2,19.242666666666665,67.24266666666666,48.0,41,141,100,5,chroma_acts
141,3,67.24266666666666,69.16266666666667,1.9200000000000017,141,145,4,5,chroma_acts
141,4,69.16266666666667,85.00266666666666,15.83999999999999,145,178,33,5,chroma_acts
141,5,85.00266666666666,99.88266666666667,14.88000000000001,178,209,31,5,chroma_acts
141,6,99.88266666666667,129.16266666666667,29.28,209,270,61,5,chroma_acts
141,7,129.16266666666667,130.60266666666666,1.4399999999999977,270,273,3,5,chroma_acts
141,8,130.60266666666666,148.5,17.897333333333336,273,309,36,5,chroma_acts
142,1,0.0,8.181333333333333,8.181333333333333,0,18,18,5,chroma_acts
142,2,8.181333333333333,12.021333333333333,3.84,18,26,8,5,chroma_acts
142,3,12.021333333333333,15.861333333333333,3.84,26,34,8,5,chroma_acts
142,4,15.861333333333333,53.78133333333333,37.919999999999995,34,113,79,5,chroma_acts
142,5,53.78133333333333,130.10133333333332,76.32,113,272,159,5,chroma_acts
142,6,130.10133333333332,145.46133333333333,15.360000000000014,272,304,32,5,chroma_acts
142,7,145.46133333333333,193.018,47.55666666666667,304,402,98,5,chroma_acts
143,1,0.0,11.317333333333332,11.317333333333332,0,24,24,6,chroma_acts
143,2,11.317333333333332,15.637333333333332,4.32,24,33,9,6,chroma_acts
143,3,15.637333333333332,26.67733333333333,11.039999999999997,33,56,23,6,chroma_acts
143,4,26.67733333333333,30.99733333333333,4.32,56,65,9,6,chroma_acts
143,5,30.99733333333333,51.157333333333334,20.160000000000004,65,107,42,6,chroma_acts
143,6,51.157333333333334,107.79733333333333,56.63999999999999,107,225,118,6,chroma_acts
143,7,107.79733333333333,123.63733333333333,15.840000000000003,225,258,33,6,chroma_acts
143,8,123.63733333333333,171.868,48.230666666666664,258,357,99,6,chroma_acts
144,1,0.0,23.701333333333334,23.701333333333334,0,50,50,4,chroma_acts
144,2,23.701333333333334,70.74133333333333,47.03999999999999,50,148,98,4,chroma_acts
144,3,70.74133333333333,85.62133333333333,14.879999999999995,148,179,31,4,chroma_acts
144,4,85.62133333333333,96.66133333333332,11.039999999999992,179,202,23,4,chroma_acts
144,5,96.66133333333332,100.98133333333332,4.320000000000007,202,211,9,4,chroma_acts
144,6,100.98133333333332,111.06133333333332,10.079999999999998,211,232,21,4,chroma_acts
144,7,111.06133333333332,132.18133333333333,21.120000000000005,232,276,44,4,chroma_acts
144,8,132.18133333333333,147.038,14.856666666666683,276,305,29,4,chroma_acts
145,1,0.0,29.695999999999998,29.695999999999998,0,78,78,5,chroma_acts
145,2,29.695999999999998,34.688,4.992000000000004,78,91,13,5,chroma_acts
145,3,34.688,39.296,4.607999999999997,91,103,12,5,chroma_acts
145,4,39.296,47.744,8.448,103,125,22,5,chroma_acts
145,5,47.744,77.696,29.951999999999998,125,203,78,5,chroma_acts
145,6,77.696,84.60799999999999,6.911999999999992,203,221,18,5,chroma_acts
145,7,84.60799999999999,113.792,29.18400000000001,221,297,76,5,chroma_acts
145,8,113.792,120.704,6.911999999999992,297,315,18,5,chroma_acts
145,9,120.704,148.421,27.717,315,386,71,5,chroma_acts
147,1,0.0,22.634666666666664,22.634666666666664,0,49,49,5,chroma_acts
147,2,22.634666666666664,32.02133333333333,9.386666666666667,49,69,20,5,chroma_acts
147,3,32.02133333333333,82.70933333333333,50.688,69,177,108,5,chroma_acts
147,4,82.70933333333333,92.096,9.38666666666667,177,197,20,5,chroma_acts
147,5,92.096,134.80533333333332,42.70933333333332,197,288,91,5,chroma_acts
147,6,134.80533333333332,139.49866666666665,4.693333333333328,288,298,10,5,chroma_acts
147,7,139.49866666666665,142.784,3.285333333333341,298,305,7,5,chroma_acts
147,8,142.784,150.47,7.686000000000007,305,320,15,5,chroma_acts
149,1,0.0,3.509333333333333,3.509333333333333,0,8,8,5,chroma_acts
149,2,3.509333333333333,7.1786666666666665,3.6693333333333333,8,16,8,5,chroma_acts
149,3,7.1786666666666665,14.517333333333333,7.338666666666667,16,32,16,5,chroma_acts
149,4,14.517333333333333,42.03733333333333,27.519999999999996,32,92,60,5,chroma_acts
149,5,42.03733333333333,57.63199999999999,15.594666666666662,92,126,34,5,chroma_acts
149,6,57.63199999999999,87.90399999999998,30.27199999999999,126,192,66,5,chroma_acts
149,7,87.90399999999998,123.67999999999998,35.775999999999996,192,270,78,5,chroma_acts
149,8,123.67999999999998,138.35733333333334,14.677333333333365,270,302,32,5,chroma_acts
149,9,138.35733333333334,197.972,59.614666666666665,302,430,128,5,chroma_acts
151,1,0.0,16.864,16.864,0,36,36,4,chroma_acts
151,2,16.864,33.663999999999994,16.799999999999994,36,71,35,4,chroma_acts
151,3,33.663999999999994,47.10399999999999,13.439999999999998,71,99,28,4,chroma_acts
151,4,47.10399999999999,49.023999999999994,1.9200000000000017,99,103,4,4,chroma_acts
151,5,49.023999999999994,62.46399999999999,13.439999999999998,103,131,28,4,chroma_acts
151,6,62.46399999999999,109.984,47.52,131,230,99,4,chroma_acts
151,7,109.984,123.42399999999999,13.439999999999998,230,258,28,4,chroma_acts
151,8,123.42399999999999,154.815,31.391000000000005,258,322,64,4,chroma_acts
153,1,0.0,30.069333333333333,30.069333333333333,0,43,43,5,chroma_acts
153,2,30.069333333333333,59.63733333333333,29.567999999999998,43,85,42,5,chroma_acts
153,3,59.63733333333333,89.90933333333334,30.272000000000006,85,128,43,5,chroma_acts
153,4,89.90933333333334,120.88533333333332,30.975999999999985,128,172,44,5,chroma_acts
153,5,120.88533333333332,149.7493333333333,28.86399999999999,172,213,41,5,chroma_acts
153,6,149.7493333333333,180.0213333333333,30.27199999999999,213,256,43,5,chroma_acts
153,7,180.0213333333333,239.8613333333333,59.84,256,341,85,5,chroma_acts
153,8,239.8613333333333,254.6453333333333,14.783999999999992,341,362,21,5,chroma_acts
153,9,254.6453333333333,269.999,15.353666666666726,362,382,20,5,chroma_acts
154,1,0.0,13.962666666666667,13.962666666666667,0,29,29,5,chroma_acts
154,2,13.962666666666667,49.29066666666667,35.328,29,101,72,5,chroma_acts
154,3,49.29066666666667,76.27733333333335,26.98666666666668,101,156,55,5,chroma_acts
154,4,76.27733333333335,88.05333333333334,11.775999999999996,156,180,24,5,chroma_acts
154,5,88.05333333333334,99.82933333333335,11.77600000000001,180,204,24,5,chroma_acts
154,6,99.82933333333335,134.66666666666666,34.837333333333305,204,275,71,5,chroma_acts
154,7,134.66666666666666,138.592,3.9253333333333558,275,283,8,5,chroma_acts
154,8,138.592,167.298,28.70599999999999,283,340,57,5,chroma_acts
156,1,0.0,7.8933333333333335,7.8933333333333335,0,17,17,4,chroma_acts
156,2,7.8933333333333335,28.544,20.650666666666666,17,61,44,4,chroma_acts
156,3,28.544,38.400000000000006,9.856000000000005,61,82,21,4,chroma_acts
156,4,38.400000000000006,98.47466666666666,60.07466666666666,82,210,128,4,chroma_acts
156,5,98.47466666666666,123.34933333333333,24.87466666666667,210,263,53,4,chroma_acts
156,6,123.34933333333333,149.632,26.28266666666667,263,319,56,4,chroma_acts
156,7,149.632,158.54933333333332,8.917333333333318,319,338,19,4,chroma_acts
156,8,158.54933333333332,204.178,45.628666666666675,338,434,96,4,chroma_acts
157,1,0.0,7.722666666666666,7.722666666666666,0,17,17,4,chroma_acts
157,2,7.722666666666666,18.762666666666664,11.04,17,40,23,4,chroma_acts
157,3,18.762666666666664,24.042666666666666,5.280000000000001,40,51,11,4,chroma_acts
157,4,24.042666666666666,78.76266666666666,54.72,51,165,114,4,chroma_acts
157,5,78.76266666666666,93.64266666666667,14.88000000000001,165,196,31,4,chroma_acts
157,6,93.64266666666667,107.56266666666667,13.920000000000002,196,225,29,4,chroma_acts
157,7,107.56266666666667,169.48266666666666,61.91999999999999,225,354,129,4,chroma_acts
157,8,169.48266666666666,180.968,11.48533333333333,354,376,22,4,chroma_acts
158,1,0.0,15.306666666666667,15.306666666666667,0,33,33,4,chroma_acts
158,2,15.306666666666667,23.285333333333334,7.978666666666667,33,50,17,4,chroma_acts
158,3,23.285333333333334,41.58933333333333,18.303999999999995,50,89,39,4,chroma_acts
158,4,41.58933333333333,52.85333333333333,11.264000000000003,89,113,24,4,chroma_acts
158,5,52.85333333333333,113.86666666666666,61.01333333333333,113,243,130,4,chroma_acts
158,6,113.86666666666666,139.68,25.813333333333347,243,298,55,4,chroma_acts
158,7,139.68,150.94400000000002,11.26400000000001,298,322,24,4,chroma_acts
158,8,150.94400000000002,198.926,47.98199999999997,322,423,101,4,chroma_acts
159,1,0.0,27.253333333333334,27.253333333333334,0,59,59,5,chroma_acts
159,2,27.253333333333334,68.55466666666668,41.301333333333346,59,147,88,5,chroma_acts
159,3,68.55466666666668,98.12266666666667,29.567999999999998,147,210,63,5,chroma_acts
159,4,98.12266666666667,102.34666666666668,4.224000000000004,210,219,9,5,chroma_acts
159,5,102.34666666666668,105.632,3.2853333333333268,219,226,7,5,chroma_acts
159,6,105.632,110.32533333333333,4.693333333333328,226,236,10,5,chroma_acts
159,7,110.32533333333333,118.77333333333334,8.448000000000008,236,254,18,5,chroma_acts
159,8,118.77333333333334,151.673,32.89966666666666,254,323,69,5,chroma_acts
160,1,0.0,11.050666666666665,11.050666666666665,0,25,25,4,chroma_acts
160,2,11.050666666666665,25.727999999999998,14.677333333333333,25,57,32,4,chroma_acts
160,3,25.727999999999998,55.08266666666666,29.354666666666663,57,121,64,4,chroma_acts
160,4,55.08266666666666,83.06133333333332,27.978666666666662,121,182,61,4,chroma_acts
160,5,83.06133333333332,124.8,41.738666666666674,182,273,91,4,chroma_acts
160,6,124.8,128.4693333333333,3.669333333333313,273,281,8,4,chroma_acts
160,7,128.4693333333333,133.9733333333333,5.503999999999991,281,293,12,4,chroma_acts
160,8,133.9733333333333,171.12533333333332,37.152000000000015,293,374,81,4,chroma_acts
160,9,171.12533333333332,217.895,46.769666666666694,374,474,100,4,chroma_acts
161,1,0.0,13.418666666666667,13.418666666666667,0,29,29,5,chroma_acts
161,2,13.418666666666667,30.784000000000002,17.365333333333336,29,66,37,5,chroma_acts
161,3,30.784000000000002,60.352,29.567999999999994,66,129,63,5,chroma_acts
161,4,60.352,105.408,45.056000000000004,129,225,96,5,chroma_acts
161,5,105.408,124.18133333333333,18.773333333333326,225,265,40,5,chroma_acts
161,6,124.18133333333333,126.99733333333333,2.8160000000000025,265,271,6,5,chroma_acts
161,7,126.99733333333333,149.52533333333332,22.52799999999999,271,319,48,5,chroma_acts
161,8,149.52533333333332,170.64533333333333,21.120000000000005,319,364,45,5,chroma_acts
161,9,170.64533333333333,204.875,34.229666666666674,364,435,71,5,chroma_acts
162,1,0.0,31.552000000000003,31.552000000000003,0,65,65,4,chroma_acts
162,2,31.552000000000003,45.781333333333336,14.229333333333333,65,94,29,4,chroma_acts
162,3,45.781333333333336,61.48266666666667,15.70133333333333,94,126,32,4,chroma_acts
162,4,61.48266666666667,94.848,33.36533333333333,126,194,68,4,chroma_acts
162,5,94.848,124.77866666666667,29.930666666666667,194,255,61,4,chroma_acts
162,6,124.77866666666667,141.46133333333336,16.68266666666669,255,289,34,4,chroma_acts
162,7,141.46133333333336,182.1866666666667,40.72533333333334,289,372,83,4,chroma_acts
162,8,182.1866666666667,189.056,6.869333333333316,372,386,14,4,chroma_acts
162,9,189.056,225.088,36.03199999999998,386,458,72,4,chroma_acts
163,1,0.0,7.295999999999999,7.295999999999999,0,16,16,5,chroma_acts
163,2,7.295999999999999,30.816,23.52,16,65,49,5,chroma_acts
163,3,30.816,38.016,7.199999999999999,65,80,15,5,chroma_acts
163,4,38.016,53.855999999999995,15.839999999999996,80,113,33,5,chroma_acts
163,5,53.855999999999995,68.736,14.88000000000001,113,144,31,5,chroma_acts
163,6,68.736,99.936,31.200000000000003,144,209,65,5,chroma_acts
163,7,99.936,115.29599999999999,15.359999999999985,209,241,32,5,chroma_acts
163,8,115.29599999999999,130.176,14.879999999999995,241,272,31,5,chroma_acts
163,9,130.176,162.029,31.85300000000001,272,337,65,5,chroma_acts
164,1,0.0,4.1386666666666665,4.1386666666666665,0,9,9,5,chroma_acts
164,2,4.1386666666666665,19.018666666666668,14.880000000000003,9,40,31,5,chroma_acts
164,3,19.018666666666668,34.37866666666667,15.36,40,72,32,5,chroma_acts
164,4,34.37866666666667,49.25866666666666,14.879999999999995,72,103,31,5,chroma_acts
164,5,49.25866666666666,80.45866666666667,31.20000000000001,103,168,65,5,chroma_acts
164,6,80.45866666666667,94.85866666666666,14.399999999999991,168,198,30,5,chroma_acts
164,7,94.85866666666666,123.65866666666666,28.799999999999997,198,258,60,5,chroma_acts
164,8,123.65866666666666,127.01866666666666,3.3599999999999994,258,265,7,5,chroma_acts
164,9,127.01866666666666,159.3,32.28133333333335,265,331,66,5,chroma_acts
165,1,0.0,4.341333333333334,4.341333333333334,0,10,10,4,chroma_acts
165,2,4.341333333333334,42.82666666666667,38.48533333333334,10,92,82,4,chroma_acts
165,3,42.82666666666667,72.39466666666667,29.567999999999998,92,155,63,4,chroma_acts
165,4,72.39466666666667,122.144,49.74933333333334,155,261,106,4,chroma_acts
165,5,122.144,126.83733333333333,4.693333333333328,261,271,10,4,chroma_acts
165,6,126.83733333333333,137.16266666666667,10.325333333333333,271,293,22,4,chroma_acts
165,7,137.16266666666667,140.91733333333335,3.7546666666666795,293,301,8,4,chroma_acts
165,8,140.91733333333335,147.95733333333334,7.039999999999992,301,316,15,4,chroma_acts
165,9,147.95733333333334,194.604,46.646666666666675,316,414,98,4,chroma_acts
166,1,0.0,3.6693333333333333,3.6693333333333333,0,8,8,4,chroma_acts
166,2,3.6693333333333333,38.70933333333333,35.04,8,81,73,4,chroma_acts
166,3,38.70933333333333,64.62933333333332,25.919999999999987,81,135,54,4,chroma_acts
166,4,64.62933333333332,76.62933333333332,12.0,135,160,25,4,chroma_acts
166,5,76.62933333333332,79.98933333333332,3.3599999999999994,160,167,7,4,chroma_acts
166,6,79.98933333333332,102.54933333333332,22.560000000000002,167,214,47,4,chroma_acts
166,7,102.54933333333332,117.90933333333332,15.36,214,246,32,4,chroma_acts
166,8,117.90933333333332,147.18933333333334,29.280000000000015,246,307,61,4,chroma_acts
166,9,147.18933333333334,180.342,33.152666666666676,307,375,68,4,chroma_acts
168,1,0.0,18.933333333333334,18.933333333333334,0,39,39,5,chroma_acts
168,2,18.933333333333334,51.31733333333333,32.384,39,105,66,5,chroma_acts
168,3,51.31733333333333,64.56533333333333,13.247999999999998,105,132,27,5,chroma_acts
168,4,64.56533333333333,70.45333333333333,5.888000000000005,132,144,12,5,chroma_acts
168,5,70.45333333333333,118.048,47.59466666666667,144,241,97,5,chroma_acts
168,6,118.048,131.7866666666667,13.738666666666688,241,269,28,5,chroma_acts
168,7,131.7866666666667,133.74933333333334,1.9626666666666495,269,273,4,5,chroma_acts
168,8,133.74933333333334,156.884,23.134666666666647,273,319,46,5,chroma_acts
170,1,0.0,15.125333333333334,15.125333333333334,0,33,33,5,chroma_acts
170,2,15.125333333333334,45.632000000000005,30.50666666666667,33,98,65,5,chroma_acts
170,3,45.632000000000005,90.688,45.056,98,194,96,5,chroma_acts
170,4,90.688,106.176,15.488,194,227,33,5,chroma_acts
170,5,106.176,118.37866666666666,12.202666666666659,227,253,26,5,chroma_acts
170,6,118.37866666666666,165.78133333333332,47.40266666666666,253,354,101,5,chroma_acts
170,7,165.78133333333332,172.8213333333333,7.039999999999992,354,369,15,5,chroma_acts
170,8,172.8213333333333,203.32799999999997,30.50666666666666,369,434,65,5,chroma_acts
170,9,203.32799999999997,217.266,13.938000000000017,434,462,28,5,chroma_acts
171,1,0.0,17.578666666666667,17.578666666666667,0,37,37,5,chroma_acts
171,2,17.578666666666667,50.21866666666667,32.64,37,105,68,5,chroma_acts
171,3,50.21866666666667,86.21866666666666,35.99999999999999,105,180,75,5,chroma_acts
171,4,86.21866666666666,89.09866666666666,2.8799999999999955,180,186,6,5,chroma_acts
171,5,89.09866666666666,100.61866666666666,11.519999999999996,186,210,24,5,chroma_acts
171,6,100.61866666666666,158.69866666666667,58.08000000000001,210,331,121,5,chroma_acts
171,7,158.69866666666667,170.21866666666665,11.519999999999982,331,355,24,5,chroma_acts
171,8,170.21866666666665,202.37866666666665,32.16,355,422,67,5,chroma_acts
171,9,202.37866666666665,217.537,15.15833333333336,422,452,30,5,chroma_acts
172,1,0.0,3.861333333333333,3.861333333333333,0,9,9,5,chroma_acts
172,2,3.861333333333333,56.42666666666667,52.565333333333335,9,121,112,5,chroma_acts
172,3,56.42666666666667,128.23466666666664,71.80799999999996,121,274,153,5,chroma_acts
172,4,128.23466666666664,136.2133333333333,7.978666666666669,274,291,17,5,chroma_acts
172,5,136.2133333333333,141.37599999999998,5.1626666666666665,291,302,11,5,chroma_acts
172,6,141.37599999999998,194.88,53.50400000000002,302,416,114,5,chroma_acts
172,7,194.88,239.93599999999998,45.05599999999998,416,512,96,5,chroma_acts
172,8,239.93599999999998,258.70933333333335,18.77333333333337,512,552,40,5,chroma_acts
172,9,258.70933333333335,319.964,61.25466666666665,552,681,129,5,chroma_acts
175,1,0.0,18.869333333333334,18.869333333333334,0,39,39,5,chroma_acts
175,2,18.869333333333334,23.776,4.906666666666666,39,49,10,5,chroma_acts
175,3,23.776,27.21066666666667,3.4346666666666685,49,56,7,5,chroma_acts
175,4,27.21066666666667,29.664,2.453333333333333,56,61,5,5,chroma_acts
175,5,29.664,45.36533333333333,15.70133333333333,61,93,32,5,chroma_acts
175,6,45.36533333333333,79.22133333333335,33.856000000000016,93,162,69,5,chroma_acts
175,7,79.22133333333335,110.13333333333334,30.911999999999992,162,225,63,5,chroma_acts
175,8,110.13333333333334,148.40533333333335,38.272000000000006,225,303,78,5,chroma_acts
175,9,148.40533333333335,190.4,41.99466666666666,303,387,84,5,chroma_acts
176,1,0.0,15.381333333333332,15.381333333333332,0,33,33,3,chroma_acts
176,2,15.381333333333332,49.46133333333333,34.08,33,104,71,3,chroma_acts
176,3,49.46133333333333,51.38133333333333,1.9200000000000017,104,108,4,3,chroma_acts
176,4,51.38133333333333,109.94133333333333,58.56,108,230,122,3,chroma_acts
176,5,109.94133333333333,114.26133333333333,4.319999999999993,230,239,9,3,chroma_acts
176,6,114.26133333333333,117.62133333333333,3.3599999999999994,239,246,7,3,chroma_acts
176,7,117.62133333333333,121.94133333333333,4.320000000000007,246,255,9,3,chroma_acts
176,8,121.94133333333333,125.30133333333333,3.3599999999999994,255,262,7,3,chroma_acts
176,9,125.30133333333333,183.553,58.251666666666665,262,382,120,3,chroma_acts
177,1,0.0,7.231999999999999,7.231999999999999,0,16,16,5,chroma_acts
177,2,7.231999999999999,23.072,15.84,16,49,33,5,chroma_acts
177,3,23.072,68.672,45.599999999999994,49,144,95,5,chroma_acts
177,4,68.672,75.872,7.200000000000003,144,159,15,5,chroma_acts
177,5,75.872,81.63199999999999,5.759999999999991,159,171,12,5,chroma_acts
177,6,81.63199999999999,103.232,21.60000000000001,171,216,45,5,chroma_acts
177,7,103.232,120.99199999999999,17.75999999999999,216,253,37,5,chroma_acts
177,8,120.99199999999999,152.359,31.36700000000002,253,317,64,5,chroma_acts
178,1,0.0,26.901333333333334,26.901333333333334,0,57,57,5,chroma_acts
178,2,26.901333333333334,29.301333333333332,2.3999999999999986,57,62,5,5,chroma_acts
178,3,29.301333333333332,69.14133333333334,39.84,62,145,83,5,chroma_acts
178,4,69.14133333333334,75.38133333333333,6.239999999999995,145,158,13,5,chroma_acts
178,5,75.38133333333333,92.18133333333333,16.799999999999997,158,193,35,5,chroma_acts
178,6,92.18133333333333,121.46133333333333,29.28,193,254,61,5,chroma_acts
178,7,121.46133333333333,156.218,34.75666666666666,254,325,71,5,chroma_acts
179,1,0.0,15.456,15.456,0,33,33,4,chroma_acts
179,2,15.456,29.855999999999998,14.399999999999999,33,63,30,4,chroma_acts
179,3,29.855999999999998,60.096,30.24,63,126,63,4,chroma_acts
179,4,60.096,153.216,93.12,126,320,194,4,chroma_acts
179,5,153.216,184.416,31.19999999999999,320,385,65,4,chroma_acts
179,6,184.416,218.016,33.599999999999994,385,455,70,4,chroma_acts
179,7,218.016,263.13599999999997,45.119999999999976,455,549,94,4,chroma_acts
179,8,263.13599999999997,279.936,16.80000000000001,549,584,35,4,chroma_acts
179,9,279.936,294.926,14.990000000000009,584,614,30,4,chroma_acts
180,1,0.0,26.496,26.496,0,56,56,4,chroma_acts
180,2,26.496,30.816,4.32,56,65,9,4,chroma_acts
180,3,30.816,48.096,17.279999999999998,65,101,36,4,chroma_acts
180,4,48.096,92.736,44.64000000000001,101,194,93,4,chroma_acts
180,5,92.736,111.456,18.72,194,233,39,4,chroma_acts
180,6,111.456,160.416,48.959999999999994,233,335,102,4,chroma_acts
180,7,160.416,205.05599999999998,44.639999999999986,335,428,93,4,chroma_acts
180,8,205.05599999999998,224.256,19.200000000000017,428,468,40,4,chroma_acts
180,9,224.256,289.304,65.04799999999997,468,602,134,4,chroma_acts
182,1,0.0,28.789333333333335,28.789333333333335,0,72,72,5,chroma_acts
182,2,28.789333333333335,46.21866666666667,17.429333333333336,72,115,43,5,chroma_acts
182,3,46.21866666666667,72.97066666666667,26.752000000000002,115,181,66,5,chroma_acts
182,4,72.97066666666667,82.69866666666667,9.727999999999994,181,205,24,5,chroma_acts
182,5,82.69866666666667,134.17600000000002,51.47733333333335,205,332,127,5,chroma_acts
182,6,134.17600000000002,162.14400000000003,27.968000000000018,332,401,69,5,chroma_acts
182,7,162.14400000000003,172.27733333333336,10.133333333333326,401,426,25,5,chroma_acts
182,8,172.27733333333336,196.59733333333338,24.32000000000002,426,486,60,5,chroma_acts
182,9,196.59733333333338,213.808,17.21066666666661,486,527,41,5,chroma_acts
183,1,0.0,12.96,12.96,0,32,32,5,chroma_acts
183,2,12.96,32.928,19.967999999999996,32,80,48,5,chroma_acts
183,3,32.928,38.336,5.408000000000001,80,93,13,5,chroma_acts
183,4,38.336,64.128,25.792,93,155,62,5,chroma_acts
183,5,64.128,72.44800000000001,8.320000000000007,155,175,20,5,chroma_acts
183,6,72.44800000000001,88.67200000000001,16.224000000000004,175,214,39,5,chroma_acts
183,7,88.67200000000001,92.00000000000001,3.328000000000003,214,222,8,5,chroma_acts
183,8,92.00000000000001,102.81600000000002,10.816000000000003,222,248,26,5,chroma_acts
183,9,102.81600000000002,111.781,8.96499999999999,248,268,20,5,chroma_acts
185,1,0.0,33.32266666666666,33.32266666666666,0,70,70,4,chroma_acts
185,2,33.32266666666666,42.922666666666665,9.600000000000001,70,90,20,4,chroma_acts
185,3,42.922666666666665,46.76266666666667,3.8400000000000034,90,98,8,4,chroma_acts
185,4,46.76266666666667,75.08266666666667,28.32,98,157,59,4,chroma_acts
185,5,75.08266666666667,77.00266666666667,1.9200000000000017,157,161,4,4,chroma_acts
185,6,77.00266666666667,134.60266666666664,57.599999999999966,161,281,120,4,chroma_acts
185,7,134.60266666666664,184.04266666666663,49.44,281,384,103,4,chroma_acts
185,8,184.04266666666663,221.96266666666665,37.920000000000016,384,463,79,4,chroma_acts
185,9,221.96266666666665,230.387,8.424333333333351,463,479,16,4,chroma_acts
186,1,0.0,15.189333333333334,15.189333333333334,0,33,33,5,chroma_acts
186,2,15.189333333333334,46.165333333333336,30.976000000000003,33,99,66,5,chroma_acts
186,3,46.165333333333336,88.87466666666666,42.70933333333332,99,190,91,5,chroma_acts
186,4,88.87466666666666,104.832,15.957333333333338,190,224,34,5,chroma_acts
186,5,104.832,109.99466666666666,5.1626666666666665,224,235,11,5,chroma_acts
186,6,109.99466666666666,117.03466666666667,7.040000000000006,235,250,15,5,chroma_acts
186,7,117.03466666666667,138.624,21.58933333333333,250,296,46,5,chroma_acts
186,8,138.624,160.68266666666668,22.05866666666668,296,343,47,5,chroma_acts
186,9,160.68266666666668,195.926,35.24333333333331,343,417,74,5,chroma_acts
195,1,0.0,67.648,67.648,0,145,145,3,chroma_acts
195,2,67.648,105.19466666666666,37.54666666666667,145,225,80,3,chroma_acts
195,3,105.19466666666666,112.23466666666667,7.040000000000006,225,240,15,3,chroma_acts
195,4,112.23466666666667,138.98666666666665,26.75199999999998,240,297,57,3,chroma_acts
195,5,138.98666666666665,142.272,3.285333333333341,297,304,7,3,chroma_acts
195,6,142.272,157.29066666666665,15.018666666666661,304,336,32,3,chroma_acts
195,7,157.29066666666665,187.328,30.03733333333335,336,400,64,3,chroma_acts
195,8,187.328,218.145,30.817000000000007,400,464,64,3,chroma_acts
196,1,0.0,30.752,30.752,0,65,65,4,chroma_acts
196,2,30.752,47.071999999999996,16.319999999999997,65,99,34,4,chroma_acts
196,3,47.071999999999996,50.912,3.8400000000000034,99,107,8,4,chroma_acts
196,4,50.912,76.352,25.440000000000005,107,160,53,4,chroma_acts
196,5,76.352,97.472,21.11999999999999,160,204,44,4,chroma_acts
196,6,97.472,127.232,29.760000000000005,204,266,62,4,chroma_acts
196,7,127.232,143.07199999999997,15.839999999999975,266,299,33,4,chroma_acts
196,8,143.07199999999997,146.432,3.3600000000000136,299,306,7,4,chroma_acts
196,9,146.432,173.945,27.513000000000005,306,362,56,4,chroma_acts
197,1,0.0,13.706666666666667,13.706666666666667,0,29,29,4,chroma_acts
197,2,13.706666666666667,48.266666666666666,34.56,29,101,72,4,chroma_acts
197,3,48.266666666666666,61.70666666666666,13.439999999999998,101,129,28,4,chroma_acts
197,4,61.70666666666666,77.06666666666666,15.36,129,161,32,4,chroma_acts
197,5,77.06666666666666,92.42666666666666,15.36,161,193,32,4,chroma_acts
197,6,92.42666666666666,115.46666666666665,23.039999999999992,193,241,48,4,chroma_acts
197,7,115.46666666666665,130.82666666666668,15.360000000000028,241,273,32,4,chroma_acts
197,8,130.82666666666668,144.26666666666668,13.439999999999998,273,301,28,4,chroma_acts
197,9,144.26666666666668,160.377,16.11033333333333,301,333,32,4,chroma_acts
199,1,0.0,15.989333333333333,15.989333333333333,0,34,34,5,chroma_acts
199,2,15.989333333333333,27.509333333333334,11.520000000000001,34,58,24,5,chroma_acts
199,3,27.509333333333334,30.389333333333333,2.879999999999999,58,64,6,5,chroma_acts
199,4,30.389333333333333,76.46933333333332,46.07999999999999,64,160,96,5,chroma_acts
199,5,76.46933333333332,93.26933333333332,16.799999999999997,160,195,35,5,chroma_acts
199,6,93.26933333333332,112.46933333333332,19.200000000000003,195,235,40,5,chroma_acts
199,7,112.46933333333332,115.82933333333332,3.3599999999999994,235,242,7,5,chroma_acts
199,8,115.82933333333332,130.22933333333333,14.400000000000006,242,272,30,5,chroma_acts
199,9,130.22933333333333,143.664,13.434666666666658,272,298,26,5,chroma_acts
201,1,0.0,9.184000000000001,9.184000000000001,0,20,20,4,chroma_acts
201,2,9.184000000000001,15.424,6.239999999999998,20,33,13,4,chroma_acts
201,3,15.424,23.104,7.68,33,49,16,4,chroma_acts
201,4,23.104,69.184,46.08,49,145,96,4,chroma_acts
201,5,69.184,77.824,8.64,145,163,18,4,chroma_acts
201,6,77.824,104.22399999999999,26.39999999999999,163,218,55,4,chroma_acts
201,7,104.22399999999999,108.064,3.8400000000000034,218,226,8,4,chroma_acts
201,8,108.064,158.104,50.04000000000002,226,329,103,4,chroma_acts
203,1,0.0,3.328,3.328,0,8,8,4,chroma_acts
203,2,3.328,18.816,15.488,8,41,33,4,chroma_acts
203,3,18.816,47.44533333333333,28.62933333333333,41,102,61,4,chroma_acts
203,4,47.44533333333333,48.85333333333333,1.4080000000000013,102,105,3,4,chroma_acts
203,5,48.85333333333333,62.464,13.610666666666667,105,134,29,4,chroma_acts
203,6,62.464,92.50133333333333,30.037333333333336,134,198,64,4,chroma_acts
203,7,92.50133333333333,94.37866666666666,1.8773333333333255,198,202,4,4,chroma_acts
203,8,94.37866666666666,163.048,68.66933333333334,202,347,145,4,chroma_acts
206,1,0.0,6.442666666666667,6.442666666666667,0,14,14,4,chroma_acts
206,2,6.442666666666667,39.562666666666665,33.12,14,83,69,4,chroma_acts
206,3,39.562666666666665,48.68266666666666,9.119999999999997,83,102,19,4,chroma_acts
206,4,48.68266666666666,62.12266666666666,13.439999999999998,102,130,28,4,chroma_acts
206,5,62.12266666666666,92.36266666666667,30.24000000000001,130,193,63,4,chroma_acts
206,6,92.36266666666667,118.76266666666668,26.400000000000006,193,248,55,4,chroma_acts
206,7,118.76266666666668,142.76266666666666,23.999999999999986,248,298,50,4,chroma_acts
206,8,142.76266666666666,172.52266666666665,29.75999999999999,298,360,62,4,chroma_acts
206,9,172.52266666666665,185.891,13.36833333333334,360,386,26,4,chroma_acts
207,1,0.0,73.20533333333333,73.20533333333333,0,128,128,4,chroma_acts
207,2,73.20533333333333,110.64533333333333,37.44,128,193,65,4,chroma_acts
207,3,110.64533333333333,115.25333333333333,4.608000000000004,193,201,8,4,chroma_acts
207,4,115.25333333333333,138.29333333333332,23.039999999999992,201,241,40,4,chroma_acts
207,5,138.29333333333332,143.47733333333332,5.1839999999999975,241,250,9,4,chroma_acts
207,6,143.47733333333332,148.08533333333332,4.608000000000004,250,258,8,4,chroma_acts
207,7,148.08533333333332,152.69333333333333,4.608000000000004,258,266,8,4,chroma_acts
207,8,152.69333333333333,156.7253333333333,4.031999999999982,266,273,7,4,chroma_acts
207,9,156.7253333333333,221.539,64.81366666666668,273,384,111,4,chroma_acts
208,1,0.0,33.57866666666666,33.57866666666666,0,69,69,4,chroma_acts
208,2,33.57866666666666,54.18666666666667,20.608000000000004,69,111,42,4,chroma_acts
208,3,54.18666666666667,68.416,14.22933333333333,111,140,29,4,chroma_acts
208,4,68.416,94.912,26.49600000000001,140,194,54,4,chroma_acts
208,5,94.912,127.78666666666668,32.87466666666667,194,261,67,4,chroma_acts
208,6,127.78666666666668,131.22133333333335,3.434666666666672,261,268,7,4,chroma_acts
208,7,131.22133333333335,162.13333333333333,30.911999999999978,268,331,63,4,chroma_acts
208,8,162.13333333333333,188.62933333333336,26.496000000000038,331,385,54,4,chroma_acts
208,9,188.62933333333336,206.761,18.131666666666632,385,420,35,4,chroma_acts
209,1,0.0,22.154666666666664,22.154666666666664,0,49,49,4,chroma_acts
209,2,22.154666666666664,29.49333333333333,7.338666666666665,49,65,16,4,chroma_acts
209,3,29.49333333333333,57.471999999999994,27.978666666666665,65,126,61,4,chroma_acts
209,4,57.471999999999994,66.64533333333333,9.173333333333332,126,146,20,4,chroma_acts
209,5,66.64533333333333,73.984,7.3386666666666684,146,162,16,4,chroma_acts
209,6,73.984,101.96266666666665,27.978666666666655,162,223,61,4,chroma_acts
209,7,101.96266666666665,161.58933333333331,59.626666666666665,223,353,130,4,chroma_acts
209,8,161.58933333333331,193.331,31.741666666666674,353,421,68,4,chroma_acts
212,1,0.0,7.562666666666667,7.562666666666667,0,17,17,4,chroma_acts
212,2,7.562666666666667,23.050666666666665,15.487999999999998,17,50,33,4,chroma_acts
212,3,23.050666666666665,37.13066666666666,14.079999999999998,50,80,30,4,chroma_acts
212,4,37.13066666666666,74.208,37.077333333333335,80,159,79,4,chroma_acts
212,5,74.208,90.16533333333334,15.957333333333338,159,193,34,4,chroma_acts
212,6,90.16533333333334,100.96,10.794666666666657,193,216,23,4,chroma_acts
212,7,100.96,124.896,23.936000000000007,216,267,51,4,chroma_acts
212,8,124.896,151.086,26.190000000000012,267,321,54,4,chroma_acts
214,1,0.0,18.45333333333333,18.45333333333333,0,41,41,4,chroma_acts
214,2,18.45333333333333,53.77066666666666,35.31733333333334,41,118,77,4,chroma_acts
214,3,53.77066666666666,81.29066666666665,27.51999999999999,118,178,60,4,chroma_acts
214,4,81.29066666666665,99.17866666666666,17.888000000000005,178,217,39,4,chroma_acts
214,5,99.17866666666666,104.68266666666666,5.504000000000005,217,229,12,4,chroma_acts
214,6,104.68266666666666,112.93866666666665,8.255999999999986,229,247,18,4,chroma_acts
214,7,112.93866666666665,114.31466666666665,1.3760000000000048,247,250,3,4,chroma_acts
214,8,114.31466666666665,145.2,30.885333333333335,250,316,66,4,chroma_acts
215,1,0.0,38.93333333333334,38.93333333333334,0,80,80,4,chroma_acts
215,2,38.93333333333334,101.73866666666667,62.80533333333334,80,208,128,4,chroma_acts
215,3,101.73866666666667,115.47733333333333,13.73866666666666,208,236,28,4,chroma_acts
215,4,115.47733333333333,135.59466666666668,20.11733333333335,236,277,41,4,chroma_acts
215,5,135.59466666666668,148.35200000000003,12.75733333333335,277,303,26,4,chroma_acts
215,6,148.35200000000003,187.60533333333336,39.25333333333333,303,383,80,4,chroma_acts
215,7,187.60533333333336,191.5306666666667,3.9253333333333273,383,391,8,4,chroma_acts
215,8,191.5306666666667,199.061,7.530333333333317,391,405,14,4,chroma_acts
219,1,0.0,41.06666666666667,41.06666666666667,0,97,97,5,chroma_acts
219,2,41.06666666666667,95.25333333333334,54.186666666666675,97,224,127,5,chroma_acts
219,3,95.25333333333334,99.52000000000001,4.266666666666666,224,234,10,5,chroma_acts
219,4,99.52000000000001,102.08000000000001,2.5600000000000023,234,240,6,5,chroma_acts
219,5,102.08000000000001,106.77333333333334,4.693333333333328,240,251,11,5,chroma_acts
219,6,106.77333333333334,108.90666666666668,2.13333333333334,251,256,5,5,chroma_acts
219,7,108.90666666666668,137.06666666666666,28.159999999999982,256,322,66,5,chroma_acts
219,8,137.06666666666666,180.439,43.37233333333333,322,422,100,5,chroma_acts
223,1,0.0,11.381333333333332,11.381333333333332,0,25,25,4,chroma_acts
223,2,11.381333333333332,15.136,3.754666666666667,25,33,8,4,chroma_acts
223,3,15.136,47.050666666666665,31.914666666666665,33,101,68,4,chroma_acts
223,4,47.050666666666665,62.06933333333333,15.018666666666668,101,133,32,4,chroma_acts
223,5,62.06933333333333,93.984,31.914666666666662,133,201,68,4,chroma_acts
223,6,93.984,122.61333333333333,28.629333333333335,201,262,61,4,chroma_acts
223,7,122.61333333333333,137.16266666666667,14.549333333333337,262,293,31,4,chroma_acts
223,8,137.16266666666667,151.712,14.549333333333323,293,324,31,4,chroma_acts
223,9,151.712,167.262,15.550000000000011,324,356,32,4,chroma_acts
227,1,0.0,28.416,28.416,0,60,60,3,chroma_acts
227,2,28.416,88.89599999999999,60.47999999999999,60,186,126,3,chroma_acts
227,3,88.89599999999999,93.216,4.320000000000007,186,195,9,3,chroma_acts
227,4,93.216,122.97599999999998,29.75999999999999,195,257,62,3,chroma_acts
227,5,122.97599999999998,131.61599999999999,8.64,257,275,18,3,chroma_acts
227,6,131.61599999999999,134.976,3.3600000000000136,275,282,7,3,chroma_acts
227,7,134.976,138.816,3.8400000000000034,282,290,8,3,chroma_acts
227,8,138.816,169.705,30.88900000000001,290,353,63,3,chroma_acts
229,1,0.0,31.477333333333334,31.477333333333334,0,68,68,4,chroma_acts
229,2,31.477333333333334,61.984,30.506666666666668,68,133,65,4,chroma_acts
229,3,61.984,65.26933333333334,3.285333333333334,133,140,7,4,chroma_acts
229,4,65.26933333333334,76.53333333333333,11.263999999999996,140,164,24,4,chroma_acts
229,5,76.53333333333333,87.328,10.794666666666672,164,187,23,4,chroma_acts
229,6,87.328,118.304,30.976,187,253,66,4,chroma_acts
229,7,118.304,122.05866666666667,3.7546666666666653,253,261,8,4,chroma_acts
229,8,122.05866666666667,140.36266666666666,18.303999999999988,261,300,39,4,chroma_acts
229,9,140.36266666666666,170.609,30.246333333333354,300,363,63,4,chroma_acts
234,1,0.0,13.461333333333332,13.461333333333332,0,29,29,5,chroma_acts
234,2,13.461333333333332,15.861333333333333,2.4000000000000004,29,34,5,5,chroma_acts
234,3,15.861333333333333,22.581333333333333,6.720000000000001,34,48,14,5,chroma_acts
234,4,22.581333333333333,30.741333333333333,8.16,48,65,17,5,chroma_acts
234,5,30.741333333333333,76.82133333333333,46.08,65,161,96,5,chroma_acts
234,6,76.82133333333333,89.78133333333332,12.959999999999994,161,188,27,5,chroma_acts
234,7,89.78133333333332,102.26133333333333,12.480000000000004,188,214,26,5,chroma_acts
234,8,102.26133333333333,107.06133333333332,4.799999999999997,214,224,10,5,chroma_acts
234,9,107.06133333333332,137.896,30.834666666666664,224,287,63,5,chroma_acts
235,1,0.0,43.46666666666667,43.46666666666667,0,93,93,5,chroma_acts
235,2,43.46666666666667,90.4,46.93333333333334,93,193,100,5,chroma_acts
235,3,90.4,104.01066666666665,13.610666666666646,193,222,29,5,chroma_acts
235,4,104.01066666666665,150.944,46.93333333333334,222,322,100,5,chroma_acts
235,5,150.944,165.96266666666665,15.018666666666661,322,354,32,5,chroma_acts
235,6,165.96266666666665,173.94133333333332,7.978666666666669,354,371,17,5,chroma_acts
235,7,173.94133333333332,187.08266666666665,13.141333333333336,371,399,28,5,chroma_acts
235,8,187.08266666666665,218.99733333333333,31.914666666666676,399,467,68,5,chroma_acts
235,9,218.99733333333333,236.112,17.114666666666665,467,502,35,5,chroma_acts
236,1,0.0,14.346666666666668,14.346666666666668,0,33,33,5,chroma_acts
236,2,14.346666666666668,41.674666666666674,27.328000000000007,33,94,61,5,chroma_acts
236,3,41.674666666666674,85.13066666666668,43.45600000000001,94,191,97,5,chroma_acts
236,4,85.13066666666668,91.85066666666668,6.719999999999999,191,206,15,5,chroma_acts
236,5,91.85066666666668,99.01866666666668,7.167999999999992,206,222,16,5,chroma_acts
236,6,99.01866666666668,141.5786666666667,42.56000000000002,222,317,95,5,chroma_acts
236,7,141.5786666666667,169.80266666666668,28.22399999999999,317,380,63,5,chroma_acts
236,8,169.80266666666668,244.1706666666667,74.36800000000002,380,546,166,5,chroma_acts
236,9,244.1706666666667,269.123,24.952333333333286,546,600,54,5,chroma_acts
239,1,0.0,19.082666666666668,19.082666666666668,0,48,48,5,chroma_acts
239,2,19.082666666666668,64.07466666666667,44.992000000000004,48,159,111,5,chroma_acts
239,3,64.07466666666667,71.37066666666666,7.295999999999992,159,177,18,5,chroma_acts
239,4,71.37066666666666,79.88266666666667,8.512,177,198,21,5,chroma_acts
239,5,79.88266666666667,92.85333333333334,12.970666666666673,198,230,32,5,chroma_acts
239,6,92.85333333333334,121.632,28.778666666666666,230,301,71,5,chroma_acts
239,7,121.632,128.11733333333333,6.48533333333333,301,317,16,5,chroma_acts
239,8,128.11733333333333,155.2746666666667,27.157333333333355,317,384,67,5,chroma_acts
239,9,155.2746666666667,164.541,9.266333333333307,384,405,21,5,chroma_acts
240,1,0.0,32.192,32.192,0,68,68,5,chroma_acts
240,2,32.192,78.27199999999999,46.07999999999999,68,164,96,5,chroma_acts
240,3,78.27199999999999,81.63199999999999,3.3599999999999994,164,171,7,5,chroma_acts
240,4,81.63199999999999,84.512,2.8800000000000097,171,177,6,5,chroma_acts
240,5,84.512,89.312,4.799999999999997,177,187,10,5,chroma_acts
240,6,89.312,92.192,2.8799999999999955,187,193,6,5,chroma_acts
240,7,92.192,108.512,16.320000000000007,193,227,34,5,chroma_acts
240,8,108.512,141.152,32.639999999999986,227,295,68,5,chroma_acts
240,9,141.152,156.51,15.358000000000004,295,325,30,5,chroma_acts
241,1,0.0,15.274666666666667,15.274666666666667,0,33,33,4,chroma_acts
241,2,15.274666666666667,28.416,13.141333333333334,33,61,28,4,chroma_acts
241,3,28.416,45.312,16.895999999999997,61,97,36,4,chroma_acts
241,4,45.312,90.368,45.056,97,193,96,4,chroma_acts
241,5,90.368,112.42666666666666,22.058666666666667,193,240,47,4,chroma_acts
241,6,112.42666666666666,124.16,11.733333333333334,240,265,25,4,chroma_acts
241,7,124.16,145.28,21.120000000000005,265,310,45,4,chroma_acts
241,8,145.28,157.48266666666666,12.202666666666659,310,336,26,4,chroma_acts
241,9,157.48266666666666,233.195,75.71233333333333,336,496,160,4,chroma_acts
242,1,0.0,39.296,39.296,0,81,81,5,chroma_acts
242,2,39.296,43.711999999999996,4.415999999999997,81,90,9,5,chroma_acts
242,3,43.711999999999996,54.99733333333333,11.285333333333334,90,113,23,5,chroma_acts
242,4,54.99733333333333,59.413333333333334,4.416000000000004,113,122,9,5,chroma_acts
242,5,59.413333333333334,117.31200000000001,57.89866666666668,122,240,118,5,chroma_acts
242,6,117.31200000000001,122.21866666666668,4.906666666666666,240,250,10,5,chroma_acts
242,7,122.21866666666668,133.01333333333335,10.794666666666672,250,272,22,5,chroma_acts
242,8,133.01333333333335,137.42933333333335,4.415999999999997,272,281,9,5,chroma_acts
242,9,137.42933333333335,159.25,21.820666666666654,281,324,43,5,chroma_acts
243,1,0.0,52.714666666666666,52.714666666666666,0,113,113,5,chroma_acts
243,2,52.714666666666666,66.32533333333333,13.610666666666667,113,142,29,5,chroma_acts
243,3,66.32533333333333,79.46666666666667,13.141333333333336,142,170,28,5,chroma_acts
243,4,79.46666666666667,81.344,1.8773333333333255,170,174,4,5,chroma_acts
243,5,81.344,151.2746666666667,69.9306666666667,174,323,149,5,chroma_acts
243,6,151.2746666666667,164.416,13.141333333333307,323,351,28,5,chroma_acts
243,7,164.416,166.29333333333335,1.877333333333354,351,355,4,5,chroma_acts
243,8,166.29333333333335,178.02666666666667,11.73333333333332,355,380,25,5,chroma_acts
243,9,178.02666666666667,197.583,19.556333333333328,380,420,40,5,chroma_acts
249,1,0.0,51.11466666666666,51.11466666666666,0,112,112,5,chroma_acts
249,2,51.11466666666666,78.176,27.061333333333344,112,171,59,5,chroma_acts
249,3,78.176,93.77066666666666,15.594666666666654,171,205,34,5,chroma_acts
249,4,93.77066666666666,106.15466666666666,12.384,205,232,27,5,chroma_acts
249,5,106.15466666666666,111.19999999999999,5.045333333333332,232,243,11,5,chroma_acts
249,6,111.19999999999999,123.58399999999999,12.384,243,270,27,5,chroma_acts
249,7,123.58399999999999,151.10399999999998,27.519999999999996,270,330,60,5,chroma_acts
249,8,151.10399999999998,153.3973333333333,2.2933333333333223,330,335,5,5,chroma_acts
249,9,153.3973333333333,182.962,29.56466666666668,335,398,63,5,chroma_acts
250,1,0.0,13.642666666666667,13.642666666666667,0,29,29,4,chroma_acts
250,2,13.642666666666667,43.882666666666665,30.24,29,92,63,4,chroma_acts
250,3,43.882666666666665,45.80266666666667,1.9200000000000017,92,96,4,4,chroma_acts
250,4,45.80266666666667,59.242666666666665,13.439999999999998,96,124,28,4,chroma_acts
250,5,59.242666666666665,104.84266666666667,45.60000000000001,124,219,95,4,chroma_acts
250,6,104.84266666666667,135.08266666666665,30.23999999999998,219,282,63,4,chroma_acts
250,7,135.08266666666665,137.00266666666664,1.9199999999999875,282,286,4,4,chroma_acts
250,8,137.00266666666664,149.48266666666666,12.480000000000018,286,312,26,4,chroma_acts
250,9,149.48266666666666,185.616,36.133333333333354,312,386,74,4,chroma_acts
252,1,0.0,37.51466666666667,37.51466666666667,0,79,79,4,chroma_acts
252,2,37.51466666666667,68.71466666666666,31.19999999999999,79,144,65,4,chroma_acts
252,3,68.71466666666666,99.91466666666666,31.200000000000003,144,209,65,4,chroma_acts
252,4,99.91466666666666,106.63466666666666,6.719999999999999,209,223,14,4,chroma_acts
252,5,106.63466666666666,138.31466666666665,31.679999999999993,223,289,66,4,chroma_acts
252,6,138.31466666666665,160.39466666666667,22.080000000000013,289,335,46,4,chroma_acts
252,7,160.39466666666667,172.87466666666666,12.47999999999999,335,361,26,4,chroma_acts
252,8,172.87466666666666,203.897,31.022333333333336,361,424,63,4,chroma_acts
254,1,0.0,28.437333333333335,28.437333333333335,0,61,61,3,chroma_acts
254,2,28.437333333333335,30.314666666666668,1.8773333333333326,61,65,4,3,chroma_acts
254,3,30.314666666666668,58.00533333333333,27.690666666666665,65,124,59,3,chroma_acts
254,4,58.00533333333333,88.98133333333332,30.975999999999992,124,190,66,3,chroma_acts
254,5,88.98133333333332,121.36533333333333,32.384,190,259,69,3,chroma_acts
254,6,121.36533333333333,142.016,20.650666666666666,259,303,44,3,chroma_acts
254,7,142.016,173.93066666666667,31.914666666666676,303,371,68,3,chroma_acts
254,8,173.93066666666667,204.667,30.736333333333334,371,435,64,3,chroma_acts
255,1,0.0,30.304,30.304,0,65,65,4,chroma_acts
255,2,30.304,71.60533333333333,41.30133333333333,65,153,88,4,chroma_acts
255,3,71.60533333333333,76.768,5.1626666666666665,153,164,11,4,chroma_acts
255,4,76.768,105.39733333333334,28.629333333333335,164,225,61,4,chroma_acts
255,5,105.39733333333334,106.80533333333334,1.4080000000000013,225,228,3,4,chroma_acts
255,6,106.80533333333334,122.29333333333334,15.488,228,261,33,4,chroma_acts
255,7,122.29333333333334,154.67733333333334,32.384,261,330,69,4,chroma_acts
255,8,154.67733333333334,190.727,36.04966666666667,330,405,75,4,chroma_acts
256,1,0.0,25.226666666666667,25.226666666666667,0,53,53,4,chroma_acts
256,2,25.226666666666667,30.506666666666668,5.280000000000001,53,64,11,4,chroma_acts
256,3,30.506666666666668,61.70666666666666,31.199999999999996,64,129,65,4,chroma_acts
256,4,61.70666666666666,91.46666666666665,29.75999999999999,129,191,62,4,chroma_acts
256,5,91.46666666666665,138.02666666666667,46.56000000000002,191,288,97,4,chroma_acts
256,6,138.02666666666667,161.06666666666666,23.039999999999992,288,336,48,4,chroma_acts
256,7,161.06666666666666,166.34666666666666,5.280000000000001,336,347,11,4,chroma_acts
256,8,166.34666666666666,200.873,34.526333333333326,347,417,70,4,chroma_acts
257,1,0.0,14.986666666666666,14.986666666666666,0,32,32,4,chroma_acts
257,2,14.986666666666666,24.586666666666666,9.6,32,52,20,4,chroma_acts
257,3,24.586666666666666,26.506666666666664,1.9199999999999982,52,56,4,4,chroma_acts
257,4,26.506666666666664,57.22666666666667,30.720000000000002,56,120,64,4,chroma_acts
257,5,57.22666666666667,75.94666666666667,18.720000000000006,120,159,39,4,chroma_acts
257,6,75.94666666666667,100.90666666666667,24.959999999999994,159,211,52,4,chroma_acts
257,7,100.90666666666667,116.26666666666667,15.36,211,243,32,4,chroma_acts
257,8,116.26666666666667,120.10666666666667,3.8400000000000034,243,251,8,4,chroma_acts
257,9,120.10666666666667,135.54,15.433333333333323,251,282,31,4,chroma_acts
258,1,0.0,15.125333333333334,15.125333333333334,0,33,33,5,chroma_acts
258,2,15.125333333333334,59.242666666666665,44.117333333333335,33,127,94,5,chroma_acts
258,3,59.242666666666665,90.21866666666666,30.976,127,193,66,5,chroma_acts
258,4,90.21866666666666,135.27466666666666,45.056,193,289,96,5,chroma_acts
258,5,135.27466666666666,137.152,1.8773333333333255,289,293,4,5,chroma_acts
258,6,137.152,139.0293333333333,1.8773333333333255,293,297,4,5,chroma_acts
258,7,139.0293333333333,150.29333333333332,11.26400000000001,297,321,24,5,chroma_acts
258,8,150.29333333333332,196.704,46.410666666666685,321,418,97,5,chroma_acts
259,1,0.0,17.642666666666667,17.642666666666667,0,36,36,5,chroma_acts
259,2,17.642666666666667,49.727999999999994,32.085333333333324,36,100,64,5,chroma_acts
259,3,49.727999999999994,54.239999999999995,4.5120000000000005,100,109,9,5,chroma_acts
259,4,54.239999999999995,57.749333333333325,3.5093333333333305,109,116,7,5,chroma_acts
259,5,57.749333333333325,62.261333333333326,4.5120000000000005,116,125,9,5,chroma_acts
259,6,62.261333333333326,209.6533333333333,147.392,125,419,294,5,chroma_acts
259,7,209.6533333333333,231.71199999999996,22.058666666666653,419,463,44,5,chroma_acts
259,8,231.71199999999996,243.308,11.596000000000032,463,485,22,5,chroma_acts
260,1,0.0,15.466666666666667,15.466666666666667,0,33,33,5,chroma_acts
260,2,15.466666666666667,32.74666666666667,17.28,33,69,36,5,chroma_acts
260,3,32.74666666666667,52.906666666666666,20.159999999999997,69,111,42,5,chroma_acts
260,4,52.906666666666666,80.74666666666667,27.840000000000003,111,169,58,5,chroma_acts
260,5,80.74666666666667,129.70666666666665,48.95999999999998,169,271,102,5,chroma_acts
260,6,129.70666666666665,172.90666666666664,43.19999999999999,271,361,90,5,chroma_acts
260,7,172.90666666666664,188.26666666666665,15.360000000000014,361,393,32,5,chroma_acts
260,8,188.26666666666665,192.10666666666665,3.8400000000000034,393,401,8,5,chroma_acts
260,9,192.10666666666665,224.929,32.82233333333335,401,468,67,5,chroma_acts
261,1,0.0,31.733333333333334,31.733333333333334,0,65,65,5,chroma_acts
261,2,31.733333333333334,35.65866666666667,3.9253333333333345,65,73,8,5,chroma_acts
261,3,35.65866666666667,39.584,3.9253333333333345,73,81,8,5,chroma_acts
261,4,39.584,61.664,22.08,81,126,45,5,chroma_acts
261,5,61.664,124.96000000000001,63.29600000000001,126,255,129,5,chroma_acts
261,6,124.96000000000001,142.62400000000002,17.664000000000016,255,291,36,5,chroma_acts
261,7,142.62400000000002,206.41066666666669,63.78666666666666,291,421,130,5,chroma_acts
261,8,206.41066666666669,224.132,17.72133333333332,421,456,35,5,chroma_acts
264,1,0.0,8.746666666666666,8.746666666666666,0,17,17,4,chroma_acts
264,2,8.746666666666666,30.506666666666668,21.76,17,57,40,4,chroma_acts
264,3,30.506666666666668,33.77066666666667,3.264000000000003,57,63,6,4,chroma_acts
264,4,33.77066666666667,52.266666666666666,18.495999999999995,63,97,34,4,chroma_acts
264,5,52.266666666666666,69.67466666666668,17.408000000000015,97,129,32,4,chroma_acts
264,6,69.67466666666668,88.17066666666668,18.495999999999995,129,163,34,4,chroma_acts
264,7,88.17066666666668,101.22666666666667,13.055999999999997,163,187,24,4,chroma_acts
264,8,101.22666666666667,140.3946666666667,39.16800000000002,187,259,72,4,chroma_acts
264,9,140.3946666666667,174.549,34.15433333333331,259,320,61,4,chroma_acts
265,1,0.0,32.23466666666666,32.23466666666666,0,68,68,3,chroma_acts
265,2,32.23466666666666,42.794666666666664,10.560000000000002,68,90,22,3,chroma_acts
265,3,42.794666666666664,47.59466666666666,4.799999999999997,90,100,10,3,chroma_acts
265,4,47.59466666666666,95.11466666666666,47.52,100,199,99,3,chroma_acts
265,5,95.11466666666666,97.51466666666667,2.4000000000000057,199,204,5,3,chroma_acts
265,6,97.51466666666667,127.75466666666667,30.239999999999995,204,267,63,3,chroma_acts
265,7,127.75466666666667,153.67466666666667,25.92,267,321,54,3,chroma_acts
265,8,153.67466666666667,234.626,80.95133333333334,321,488,167,3,chroma_acts
266,1,0.0,169.38666666666666,169.38666666666666,0,346,346,4,chroma_acts
266,2,169.38666666666666,175.27466666666666,5.888000000000005,346,358,12,4,chroma_acts
266,3,175.27466666666666,183.12533333333334,7.850666666666683,358,374,16,4,chroma_acts
266,4,183.12533333333334,187.05066666666667,3.9253333333333273,374,382,8,4,chroma_acts
266,5,187.05066666666667,190.976,3.9253333333333273,382,390,8,4,chroma_acts
266,6,190.976,194.90133333333333,3.9253333333333273,390,398,8,4,chroma_acts
266,7,194.90133333333333,196.864,1.9626666666666779,398,402,4,4,chroma_acts
266,8,196.864,204.626,7.7620000000000005,402,416,14,4,chroma_acts
267,1,0.0,63.04,63.04,0,135,135,4,chroma_acts
267,2,63.04,68.20266666666666,5.162666666666659,135,146,11,4,chroma_acts
267,3,68.20266666666666,78.05866666666667,9.856000000000009,146,167,21,4,chroma_acts
267,4,78.05866666666667,82.28266666666666,4.2239999999999895,167,176,9,4,chroma_acts
267,5,82.28266666666666,101.056,18.77333333333334,176,216,40,4,chroma_acts
267,6,101.056,130.62400000000002,29.568000000000026,216,279,63,4,chroma_acts
267,7,130.62400000000002,156.90666666666667,26.282666666666643,279,335,56,4,chroma_acts
267,8,156.90666666666667,173.099,16.192333333333323,335,368,33,4,chroma_acts
268,1,0.0,30.005333333333333,30.005333333333333,0,73,73,4,chroma_acts
268,2,30.005333333333333,33.333333333333336,3.328000000000003,73,81,8,4,chroma_acts
268,3,33.333333333333336,36.66133333333333,3.327999999999996,81,89,8,4,chroma_acts
268,4,36.66133333333333,53.30133333333333,16.64,89,129,40,4,chroma_acts
268,5,53.30133333333333,110.29333333333335,56.99200000000002,129,266,137,4,chroma_acts
268,6,110.29333333333335,113.62133333333335,3.328000000000003,266,274,8,4,chroma_acts
268,7,113.62133333333335,133.17333333333335,19.551999999999992,274,321,47,4,chroma_acts
268,8,133.17333333333335,186.83733333333336,53.664000000000016,321,450,129,4,chroma_acts
268,9,186.83733333333336,213.333,26.495666666666637,450,512,62,4,chroma_acts
269,1,0.0,41.19466666666666,41.19466666666666,0,60,60,4,chroma_acts
269,2,41.19466666666666,57.834666666666664,16.64,60,84,24,4,chroma_acts
269,3,57.834666666666664,59.221333333333334,1.3866666666666703,84,86,2,4,chroma_acts
269,4,59.221333333333334,103.59466666666667,44.373333333333335,86,150,64,4,chroma_acts
269,5,103.59466666666667,118.848,15.25333333333333,150,172,22,4,chroma_acts
269,6,118.848,132.02133333333336,13.17333333333336,172,191,19,4,chroma_acts
269,7,132.02133333333336,175.008,42.98666666666665,191,253,62,4,chroma_acts
269,8,175.008,183.19,8.181999999999988,253,263,10,4,chroma_acts
273,1,0.0,39.08266666666667,39.08266666666667,0,64,64,4,chroma_acts
273,2,39.08266666666667,67.54133333333334,28.458666666666673,64,110,46,4,chroma_acts
273,3,67.54133333333334,94.76266666666668,27.221333333333334,110,154,44,4,chroma_acts
273,4,94.76266666666668,125.07733333333334,30.314666666666668,154,203,49,4,chroma_acts
273,5,125.07733333333334,132.50133333333332,7.423999999999978,203,215,12,4,chroma_acts
273,6,132.50133333333332,153.536,21.03466666666668,215,249,34,4,chroma_acts
273,7,153.536,167.76533333333333,14.22933333333333,249,272,23,4,chroma_acts
273,8,167.76533333333333,192.512,24.74666666666667,272,312,40,4,chroma_acts
273,9,192.512,240.025,47.513000000000005,312,387,75,4,chroma_acts
275,1,0.0,15.733333333333334,15.733333333333334,0,34,34,3,chroma_acts
275,2,15.733333333333334,73.93066666666667,58.19733333333333,34,158,124,3,chroma_acts
275,3,73.93066666666667,87.072,13.141333333333336,158,186,28,3,chroma_acts
275,4,87.072,112.88533333333334,25.813333333333333,186,241,55,3,chroma_acts
275,5,112.88533333333334,120.864,7.978666666666669,241,258,17,3,chroma_acts
275,6,120.864,134.00533333333334,13.141333333333336,258,286,28,3,chroma_acts
275,7,134.00533333333334,135.88266666666667,1.8773333333333255,286,290,4,3,chroma_acts
275,8,135.88266666666667,166.733,30.85033333333334,290,354,64,3,chroma_acts
279,1,0.0,30.272,30.272,0,64,64,4,chroma_acts
279,2,30.272,84.032,53.76,64,176,112,4,chroma_acts
279,3,84.032,91.232,7.200000000000003,176,191,15,4,chroma_acts
279,4,91.232,120.99199999999999,29.75999999999999,191,253,62,4,chroma_acts
279,5,120.99199999999999,135.392,14.400000000000006,253,283,30,4,chroma_acts
279,6,135.392,167.552,32.16,283,350,67,4,chroma_acts
279,7,167.552,213.632,46.08000000000001,350,446,96,4,chroma_acts
279,8,213.632,228.512,14.879999999999995,446,477,31,4,chroma_acts
279,9,228.512,304.763,76.25099999999998,477,634,157,4,chroma_acts
280,1,0.0,28.66133333333333,28.66133333333333,0,62,62,4,chroma_acts
280,2,28.66133333333333,62.922666666666665,34.26133333333333,62,135,73,4,chroma_acts
280,3,62.922666666666665,105.16266666666667,42.24,135,225,90,4,chroma_acts
280,4,105.16266666666667,130.5066666666667,25.344000000000023,225,279,54,4,chroma_acts
280,5,130.5066666666667,172.27733333333333,41.77066666666664,279,368,89,4,chroma_acts
280,6,172.27733333333333,210.29333333333335,38.01600000000002,368,449,81,4,chroma_acts
280,7,210.29333333333335,213.57866666666666,3.2853333333333126,449,456,7,4,chroma_acts
280,8,213.57866666666666,244.481,30.90233333333333,456,520,64,4,chroma_acts
281,1,0.0,44.672000000000004,44.672000000000004,0,92,92,4,chroma_acts
281,2,44.672000000000004,74.11200000000001,29.440000000000005,92,152,60,4,chroma_acts
281,3,74.11200000000001,77.05600000000001,2.9440000000000026,152,158,6,4,chroma_acts
281,4,77.05600000000001,124.16000000000001,47.104,158,254,96,4,chroma_acts
281,5,124.16000000000001,183.04000000000002,58.88000000000001,254,374,120,4,chroma_acts
281,6,183.04000000000002,186.47466666666668,3.434666666666658,374,381,7,4,chroma_acts
281,7,186.47466666666668,252.22400000000002,65.74933333333334,381,515,134,4,chroma_acts
281,8,252.22400000000002,268.659,16.434999999999974,515,547,32,4,chroma_acts
282,1,0.0,29.48266666666667,29.48266666666667,0,61,61,4,chroma_acts
282,2,29.48266666666667,78.54933333333334,49.06666666666666,61,161,100,4,chroma_acts
282,3,78.54933333333334,86.89066666666668,8.341333333333338,161,178,17,4,chroma_acts
282,4,86.89066666666668,141.35466666666667,54.464,178,289,111,4,chroma_acts
282,5,141.35466666666667,160.98133333333334,19.626666666666665,289,329,40,4,chroma_acts
282,6,160.98133333333334,204.65066666666667,43.66933333333333,329,418,89,4,chroma_acts
282,7,204.65066666666667,213.4826666666667,8.832000000000022,418,436,18,4,chroma_acts
282,8,213.4826666666667,266.9653333333334,53.48266666666669,436,545,109,4,chroma_acts
282,9,266.9653333333334,284.97,18.00466666666665,545,580,35,4,chroma_acts
283,1,0.0,30.272,30.272,0,64,64,3,chroma_acts
283,2,30.272,38.912,8.64,64,82,18,3,chroma_acts
283,3,38.912,61.952,23.04,82,130,48,3,chroma_acts
283,4,61.952,99.872,37.92,130,209,79,3,chroma_acts
283,5,99.872,102.27199999999999,2.3999999999999915,209,214,5,3,chroma_acts
283,6,102.27199999999999,131.072,28.80000000000001,214,274,60,3,chroma_acts
283,7,131.072,185.792,54.72,274,388,114,3,chroma_acts
283,8,185.792,217.188,31.395999999999987,388,452,64,3,chroma_acts
287,1,0.0,28.714666666666666,28.714666666666666,0,60,60,4,chroma_acts
287,2,28.714666666666666,54.154666666666664,25.439999999999998,60,113,53,4,chroma_acts
287,3,54.154666666666664,57.99466666666666,3.8399999999999963,113,121,8,4,chroma_acts
287,4,57.99466666666666,103.11466666666666,45.120000000000005,121,215,94,4,chroma_acts
287,5,103.11466666666666,129.99466666666666,26.879999999999995,215,271,56,4,chroma_acts
287,6,129.99466666666666,133.35466666666665,3.359999999999985,271,278,7,4,chroma_acts
287,7,133.35466666666665,153.51466666666667,20.160000000000025,278,320,42,4,chroma_acts
287,8,153.51466666666667,162.63466666666665,9.119999999999976,320,339,19,4,chroma_acts
287,9,162.63466666666665,226.407,63.772333333333364,339,470,131,4,chroma_acts
288,1,0.0,26.93333333333333,26.93333333333333,0,57,57,5,chroma_acts
288,2,26.93333333333333,29.333333333333332,2.400000000000002,57,62,5,5,chroma_acts
288,3,29.333333333333332,46.61333333333334,17.280000000000005,62,98,36,5,chroma_acts
288,4,46.61333333333334,90.77333333333333,44.15999999999999,98,190,92,5,chroma_acts
288,5,90.77333333333333,96.05333333333333,5.280000000000001,190,201,11,5,chroma_acts
288,6,96.05333333333333,99.41333333333333,3.3599999999999994,201,208,7,5,chroma_acts
288,7,99.41333333333333,103.73333333333333,4.320000000000007,208,217,9,5,chroma_acts
288,8,103.73333333333333,122.93333333333334,19.200000000000003,217,257,40,5,chroma_acts
288,9,122.93333333333334,184.32,61.386666666666656,257,383,126,5,chroma_acts
289,1,0.0,6.794666666666667,6.794666666666667,0,15,15,4,chroma_acts
289,2,6.794666666666667,25.514666666666667,18.72,15,54,39,4,chroma_acts
289,3,25.514666666666667,30.794666666666664,5.279999999999998,54,65,11,4,chroma_acts
289,4,30.794666666666664,58.154666666666664,27.36,65,122,57,4,chroma_acts
289,5,58.154666666666664,82.63466666666666,24.479999999999997,122,173,51,4,chroma_acts
289,6,82.63466666666666,114.31466666666665,31.679999999999993,173,239,66,4,chroma_acts
289,7,114.31466666666665,161.83466666666666,47.52000000000001,239,338,99,4,chroma_acts
289,8,161.83466666666666,180.495,18.66033333333334,338,375,37,4,chroma_acts
290,1,0.0,12.789333333333333,12.789333333333333,0,27,27,4,chroma_acts
290,2,12.789333333333333,32.416000000000004,19.626666666666672,27,67,40,4,chroma_acts
290,3,32.416000000000004,36.832,4.415999999999997,67,76,9,4,chroma_acts
290,4,36.832,85.40800000000002,48.576000000000015,76,175,99,4,chroma_acts
290,5,85.40800000000002,93.74933333333334,8.341333333333324,175,192,17,4,chroma_acts
290,6,93.74933333333334,126.62400000000001,32.87466666666667,192,259,67,4,chroma_acts
290,7,126.62400000000001,130.54933333333332,3.925333333333313,259,267,8,4,chroma_acts
290,8,130.54933333333332,197.744,67.19466666666668,267,402,135,4,chroma_acts
291,1,0.0,15.893333333333333,15.893333333333333,0,34,34,4,chroma_acts
291,2,15.893333333333333,34.61333333333333,18.72,34,73,39,4,chroma_acts
291,3,34.61333333333333,64.37333333333333,29.760000000000005,73,135,62,4,chroma_acts
291,4,64.37333333333333,69.65333333333334,5.280000000000001,135,146,11,4,chroma_acts
291,5,69.65333333333334,95.57333333333332,25.919999999999987,146,200,54,4,chroma_acts
291,6,95.57333333333332,135.41333333333333,39.84,200,283,83,4,chroma_acts
291,7,135.41333333333333,181.97333333333333,46.56,283,380,97,4,chroma_acts
291,8,181.97333333333333,199.916,17.942666666666668,380,416,36,4,chroma_acts
292,1,0.0,30.944000000000003,30.944000000000003,0,64,64,4,chroma_acts
292,2,30.944000000000003,46.64533333333333,15.70133333333333,64,96,32,4,chroma_acts
292,3,46.64533333333333,81.97333333333334,35.32800000000001,96,168,72,4,chroma_acts
292,4,81.97333333333334,125.152,43.17866666666666,168,256,88,4,chroma_acts
292,5,125.152,140.85333333333335,15.701333333333352,256,288,32,4,chroma_acts
292,6,140.85333333333335,187.4666666666667,46.613333333333344,288,383,95,4,chroma_acts
292,7,187.4666666666667,239.96800000000002,52.50133333333332,383,490,107,4,chroma_acts
292,8,239.96800000000002,263.126,23.15799999999996,490,536,46,4,chroma_acts
293,1,0.0,7.477333333333332,7.477333333333332,0,17,17,3,chroma_acts
293,2,7.477333333333332,21.23733333333333,13.759999999999996,17,47,30,3,chroma_acts
293,3,21.23733333333333,29.49333333333333,8.256,47,65,18,3,chroma_acts
293,4,29.49333333333333,66.64533333333333,37.152,65,146,81,3,chroma_acts
293,5,66.64533333333333,87.74399999999999,21.09866666666666,146,192,46,3,chroma_acts
293,6,87.74399999999999,95.99999999999999,8.256,192,210,18,3,chroma_acts
293,7,95.99999999999999,103.33866666666665,7.3386666666666684,210,226,16,3,chroma_acts
293,8,103.33866666666665,118.01599999999999,14.677333333333337,226,258,32,3,chroma_acts
293,9,118.01599999999999,148.731,30.715000000000003,258,323,65,3,chroma_acts
294,1,0.0,39.40266666666666,39.40266666666666,0,83,83,5,chroma_acts
294,2,39.40266666666666,45.16266666666667,5.760000000000005,83,95,12,5,chroma_acts
294,3,45.16266666666667,60.522666666666666,15.36,95,127,32,5,chroma_acts
294,4,60.522666666666666,62.44266666666666,1.9199999999999946,127,131,4,5,chroma_acts
294,5,62.44266666666666,75.88266666666667,13.440000000000005,131,159,28,5,chroma_acts
294,6,75.88266666666667,132.04266666666666,56.16,159,276,117,5,chroma_acts
294,7,132.04266666666666,137.80266666666668,5.760000000000019,276,288,12,5,chroma_acts
294,8,137.80266666666668,186.963,49.16033333333331,288,389,101,5,chroma_acts
296,1,0.0,22.773333333333333,22.773333333333333,0,33,33,5,chroma_acts
296,2,22.773333333333333,68.53333333333335,45.76000000000001,33,99,66,5,chroma_acts
296,3,68.53333333333335,71.30666666666667,2.7733333333333263,99,103,4,5,chroma_acts
296,4,71.30666666666667,74.08000000000001,2.7733333333333405,103,107,4,5,chroma_acts
296,5,74.08000000000001,77.54666666666668,3.4666666666666686,107,112,5,5,chroma_acts
296,6,77.54666666666668,87.25333333333334,9.706666666666663,112,126,14,5,chroma_acts
296,7,87.25333333333334,110.82666666666668,23.573333333333338,126,160,34,5,chroma_acts
296,8,110.82666666666668,182.24,71.41333333333333,160,263,103,5,chroma_acts
296,9,182.24,198.857,16.61699999999999,263,285,22,5,chroma_acts
297,1,0.0,6.976,6.976,0,15,15,4,chroma_acts
297,2,6.976,22.816,15.84,15,48,33,4,chroma_acts
297,3,22.816,38.176,15.360000000000003,48,80,32,4,chroma_acts
297,4,38.176,85.216,47.03999999999999,80,178,98,4,chroma_acts
297,5,85.216,100.096,14.88000000000001,178,209,31,4,chroma_acts
297,6,100.096,114.496,14.399999999999991,209,239,30,4,chroma_acts
297,7,114.496,130.33599999999998,15.83999999999999,239,272,33,4,chroma_acts
297,8,130.33599999999998,145.696,15.360000000000014,272,304,32,4,chroma_acts
297,9,145.696,192.96,47.26400000000001,304,401,97,4,chroma_acts
298,1,0.0,6.506666666666667,6.506666666666667,0,14,14,4,chroma_acts
298,2,6.506666666666667,35.78666666666666,29.279999999999994,14,75,61,4,chroma_acts
298,3,35.78666666666666,42.026666666666664,6.240000000000002,75,88,13,4,chroma_acts
298,4,42.026666666666664,50.18666666666667,8.160000000000004,88,105,17,4,chroma_acts
298,5,50.18666666666667,82.82666666666667,32.64,105,173,68,4,chroma_acts
298,6,82.82666666666667,114.98666666666666,32.16,173,240,67,4,chroma_acts
298,7,114.98666666666666,121.70666666666666,6.719999999999999,240,254,14,4,chroma_acts
298,8,121.70666666666666,134.18666666666667,12.480000000000004,254,280,26,4,chroma_acts
298,9,134.18666666666667,191.986,57.79933333333332,280,399,119,4,chroma_acts
299,1,0.0,14.901333333333332,14.901333333333332,0,32,32,5,chroma_acts
299,2,14.901333333333332,26.901333333333334,12.000000000000002,32,57,25,5,chroma_acts
299,3,26.901333333333334,34.58133333333333,7.68,57,73,16,5,chroma_acts
299,4,34.58133333333333,60.98133333333333,26.4,73,128,55,5,chroma_acts
299,5,60.98133333333333,108.02133333333333,47.04,128,226,98,5,chroma_acts
299,6,108.02133333333333,120.98133333333332,12.959999999999994,226,253,27,5,chroma_acts
299,7,120.98133333333332,171.86133333333333,50.88000000000001,253,359,106,5,chroma_acts
299,8,171.86133333333333,241.94133333333332,70.07999999999998,359,505,146,5,chroma_acts
299,9,241.94133333333332,262.006,20.064666666666653,505,545,40,5,chroma_acts
300,1,0.0,8.362666666666666,8.362666666666666,0,18,18,5,chroma_acts
300,2,8.362666666666666,26.602666666666664,18.24,18,56,38,5,chroma_acts
300,3,26.602666666666664,54.922666666666665,28.32,56,115,59,5,chroma_acts
300,4,54.922666666666665,72.20266666666666,17.279999999999994,115,151,36,5,chroma_acts
300,5,72.20266666666666,83.72266666666667,11.52000000000001,151,175,24,5,chroma_acts
300,6,83.72266666666667,115.88266666666667,32.16,175,242,67,5,chroma_acts
300,7,115.88266666666667,124.04266666666666,8.159999999999997,242,259,17,5,chroma_acts
300,8,124.04266666666666,136.04266666666666,12.0,259,284,25,5,chroma_acts
300,9,136.04266666666666,169.587,33.54433333333333,284,352,68,5,chroma_acts
301,1,0.0,30.762666666666664,30.762666666666664,0,65,65,4,chroma_acts
301,2,30.762666666666664,65.32266666666666,34.56,65,137,72,4,chroma_acts
301,3,65.32266666666666,93.16266666666667,27.840000000000003,137,195,58,4,chroma_acts
301,4,93.16266666666667,120.52266666666667,27.36,195,252,57,4,chroma_acts
301,5,120.52266666666667,154.60266666666666,34.08,252,323,71,4,chroma_acts
301,6,154.60266666666666,169.96266666666668,15.360000000000014,323,355,32,4,chroma_acts
301,7,169.96266666666668,209.32266666666666,39.359999999999985,355,437,82,4,chroma_acts
301,8,209.32266666666666,214.60266666666666,5.280000000000001,437,448,11,4,chroma_acts
301,9,214.60266666666666,279.682,65.07933333333335,448,582,134,4,chroma_acts
302,1,0.0,15.402666666666665,15.402666666666665,0,33,33,4,chroma_acts
302,2,15.402666666666665,29.322666666666663,13.919999999999998,33,62,29,4,chroma_acts
302,3,29.322666666666663,46.602666666666664,17.28,62,98,36,4,chroma_acts
302,4,46.602666666666664,49.962666666666664,3.3599999999999994,98,105,7,4,chroma_acts
302,5,49.962666666666664,77.80266666666667,27.840000000000003,105,163,58,4,chroma_acts
302,6,77.80266666666667,92.68266666666666,14.879999999999995,163,194,31,4,chroma_acts
302,7,92.68266666666666,108.52266666666667,15.840000000000003,194,227,33,4,chroma_acts
302,8,108.52266666666667,139.24266666666668,30.720000000000013,227,291,64,4,chroma_acts
302,9,139.24266666666668,186.542,47.29933333333332,291,388,97,4,chroma_acts
303,1,0.0,11.637333333333334,11.637333333333334,0,33,33,5,chroma_acts
303,2,11.637333333333334,38.112,26.474666666666668,33,106,73,5,chroma_acts
303,3,38.112,83.808,45.696000000000005,106,232,126,5,chroma_acts
303,4,83.808,108.46933333333334,24.66133333333333,232,300,68,5,chroma_acts
303,5,108.46933333333334,111.73333333333333,3.263999999999996,300,309,9,5,chroma_acts
303,6,111.73333333333333,116.81066666666668,5.077333333333343,309,323,14,5,chroma_acts
303,7,116.81066666666668,120.07466666666667,3.263999999999996,323,332,9,5,chroma_acts
303,8,120.07466666666667,139.29600000000002,19.221333333333348,332,385,53,5,chroma_acts
303,9,139.29600000000002,194.521,55.224999999999966,385,536,151,5,chroma_acts
304,1,0.0,14.837333333333333,14.837333333333333,0,32,32,4,chroma_acts
304,2,14.837333333333333,50.976,36.138666666666666,32,109,77,4,chroma_acts
304,3,50.976,75.38133333333333,24.40533333333333,109,161,52,4,chroma_acts
304,4,75.38133333333333,119.49866666666667,44.117333333333335,161,255,94,4,chroma_acts
304,5,119.49866666666667,126.53866666666666,7.039999999999992,255,270,15,4,chroma_acts
304,6,126.53866666666666,139.21066666666667,12.672000000000011,270,297,27,4,chroma_acts
304,7,139.21066666666667,143.4346666666667,4.224000000000018,297,306,9,4,chroma_acts
304,8,143.4346666666667,176.693,33.258333333333326,306,375,69,4,chroma_acts
305,1,0.0,8.192,8.192,0,18,18,3,chroma_acts
305,2,8.192,21.152,12.96,18,45,27,3,chroma_acts
305,3,21.152,38.912,17.759999999999998,45,82,37,3,chroma_acts
305,4,38.912,66.752,27.839999999999996,82,140,58,3,chroma_acts
305,5,66.752,75.872,9.120000000000005,140,159,19,3,chroma_acts
305,6,75.872,82.112,6.239999999999995,159,172,13,3,chroma_acts
305,7,82.112,99.872,17.760000000000005,172,209,37,3,chroma_acts
305,8,99.872,144.513,44.641000000000005,209,301,92,3,chroma_acts
306,1,0.0,16.725333333333335,16.725333333333335,0,35,35,5,chroma_acts
306,2,16.725333333333335,32.56533333333333,15.839999999999993,35,68,33,5,chroma_acts
306,3,32.56533333333333,92.56533333333333,60.0,68,193,125,5,chroma_acts
306,4,92.56533333333333,123.76533333333333,31.200000000000003,193,258,65,5,chroma_acts
306,5,123.76533333333333,139.12533333333334,15.360000000000014,258,290,32,5,chroma_acts
306,6,139.12533333333334,142.96533333333335,3.8400000000000034,290,298,8,5,chroma_acts
306,7,142.96533333333335,155.92533333333333,12.95999999999998,298,325,27,5,chroma_acts
306,8,155.92533333333333,159.76533333333333,3.8400000000000034,325,333,8,5,chroma_acts
306,9,159.76533333333333,201.784,42.01866666666666,333,419,86,5,chroma_acts
307,1,0.0,14.698666666666666,14.698666666666666,0,31,31,4,chroma_acts
307,2,14.698666666666666,15.658666666666667,0.9600000000000009,31,33,2,4,chroma_acts
307,3,15.658666666666667,22.378666666666664,6.719999999999997,33,47,14,4,chroma_acts
307,4,22.378666666666664,39.65866666666667,17.280000000000005,47,83,36,4,chroma_acts
307,5,39.65866666666667,85.73866666666666,46.07999999999999,83,179,96,4,chroma_acts
307,6,85.73866666666666,101.09866666666666,15.36,179,211,32,4,chroma_acts
307,7,101.09866666666666,116.93866666666666,15.840000000000003,211,244,33,4,chroma_acts
307,8,116.93866666666666,133.25866666666667,16.320000000000007,244,278,34,4,chroma_acts
307,9,133.25866666666667,194.748,61.48933333333332,278,405,127,4,chroma_acts
308,1,0.0,5.568,5.568,0,12,12,3,chroma_acts
308,2,5.568,23.328,17.759999999999998,12,49,37,3,chroma_acts
308,3,23.328,38.687999999999995,15.359999999999996,49,81,32,3,chroma_acts
308,4,38.687999999999995,83.32799999999999,44.63999999999999,81,174,93,3,chroma_acts
308,5,83.32799999999999,100.128,16.80000000000001,174,209,35,3,chroma_acts
308,6,100.128,115.48799999999999,15.359999999999985,209,241,32,3,chroma_acts
308,7,115.48799999999999,146.68800000000002,31.20000000000003,241,306,65,3,chroma_acts
308,8,146.68800000000002,177.888,31.19999999999999,306,371,65,3,chroma_acts
308,9,177.888,223.45,45.56199999999998,371,464,93,3,chroma_acts
309,1,0.0,17.866666666666667,17.866666666666667,0,38,38,4,chroma_acts
309,2,17.866666666666667,42.346666666666664,24.479999999999997,38,89,51,4,chroma_acts
309,3,42.346666666666664,45.70666666666666,3.3599999999999994,89,96,7,4,chroma_acts
309,4,45.70666666666666,105.22666666666667,59.52000000000001,96,220,124,4,chroma_acts
309,5,105.22666666666667,137.86666666666667,32.64,220,288,68,4,chroma_acts
309,6,137.86666666666667,148.90666666666667,11.039999999999992,288,311,23,4,chroma_acts
309,7,148.90666666666667,152.26666666666668,3.3600000000000136,311,318,7,4,chroma_acts
309,8,152.26666666666668,215.846,63.579333333333324,318,449,131,4,chroma_acts
310,1,0.0,15.946666666666667,15.946666666666667,0,34,34,4,chroma_acts
310,2,15.946666666666667,36.586666666666666,20.64,34,77,43,4,chroma_acts
310,3,36.586666666666666,38.50666666666667,1.9200000000000017,77,81,4,4,chroma_acts
310,4,38.50666666666667,44.266666666666666,5.759999999999998,81,93,12,4,chroma_acts
310,5,44.266666666666666,59.14666666666667,14.880000000000003,93,124,31,4,chroma_acts
310,6,59.14666666666667,106.18666666666667,47.04,124,222,98,4,chroma_acts
310,7,106.18666666666667,135.94666666666666,29.75999999999999,222,284,62,4,chroma_acts
310,8,135.94666666666666,182.98666666666665,47.03999999999999,284,382,98,4,chroma_acts
310,9,182.98666666666665,216.346,33.35933333333335,382,450,68,4,chroma_acts
311,1,0.0,28.842666666666666,28.842666666666666,0,61,61,5,chroma_acts
311,2,28.842666666666666,60.04266666666666,31.199999999999996,61,126,65,5,chroma_acts
311,3,60.04266666666666,110.92266666666666,50.879999999999995,126,232,106,5,chroma_acts
311,4,110.92266666666666,123.88266666666667,12.960000000000008,232,259,27,5,chroma_acts
311,5,123.88266666666667,139.72266666666667,15.840000000000003,259,292,33,5,chroma_acts
311,6,139.72266666666667,153.16266666666667,13.439999999999998,292,320,28,5,chroma_acts
311,7,153.16266666666667,177.64266666666668,24.480000000000018,320,371,51,5,chroma_acts
311,8,177.64266666666668,235.828,58.18533333333332,371,491,120,5,chroma_acts
313,1,0.0,13.472,13.472,0,29,29,4,chroma_acts
313,2,13.472,29.311999999999998,15.839999999999998,29,62,33,4,chroma_acts
313,3,29.311999999999998,54.272,24.96,62,114,52,4,chroma_acts
313,4,54.272,58.592,4.32,114,123,9,4,chroma_acts
313,5,58.592,99.392,40.8,123,208,85,4,chroma_acts
313,6,99.392,125.792,26.400000000000006,208,263,55,4,chroma_acts
313,7,125.792,137.31199999999998,11.519999999999982,263,287,24,4,chroma_acts
313,8,137.31199999999998,168.512,31.200000000000017,287,352,65,4,chroma_acts
313,9,168.512,190.521,22.008999999999986,352,396,44,4,chroma_acts
314,1,0.0,8.970666666666666,8.970666666666666,0,20,20,4,chroma_acts
314,2,8.970666666666666,30.986666666666665,22.016,20,68,48,4,chroma_acts
314,3,30.986666666666665,33.279999999999994,2.2933333333333294,68,73,5,4,chroma_acts
314,4,33.279999999999994,34.656,1.3760000000000048,73,76,3,4,chroma_acts
314,5,34.656,44.288,9.631999999999998,76,97,21,4,chroma_acts
314,6,44.288,88.77866666666665,44.490666666666655,97,194,97,4,chroma_acts
314,7,88.77866666666665,115.83999999999999,27.061333333333337,194,253,59,4,chroma_acts
314,8,115.83999999999999,140.14933333333332,24.309333333333328,253,306,53,4,chroma_acts
314,9,140.14933333333332,184.923,44.773666666666685,306,402,96,4,chroma_acts
317,1,0.0,33.376,33.376,0,72,72,5,chroma_acts
317,2,33.376,62.943999999999996,29.567999999999998,72,135,63,5,chroma_acts
317,3,62.943999999999996,78.90133333333333,15.957333333333331,135,169,34,5,chroma_acts
317,4,78.90133333333333,91.57333333333334,12.672000000000011,169,196,27,5,chroma_acts
317,5,91.57333333333334,138.5066666666667,46.93333333333335,196,296,100,5,chroma_acts
317,6,138.5066666666667,152.11733333333333,13.610666666666646,296,325,29,5,chroma_acts
317,7,152.11733333333333,161.03466666666668,8.917333333333346,325,344,19,5,chroma_acts
317,8,161.03466666666668,201.646,40.611333333333306,344,429,85,5,chroma_acts
321,1,0.0,15.157333333333332,15.157333333333332,0,32,32,4,chroma_acts
321,2,15.157333333333332,45.87733333333333,30.72,32,96,64,4,chroma_acts
321,3,45.87733333333333,69.87733333333333,23.999999999999993,96,146,50,4,chroma_acts
321,4,69.87733333333333,73.71733333333333,3.8400000000000034,146,154,8,4,chroma_acts
321,5,73.71733333333333,90.51733333333333,16.799999999999997,154,189,35,4,chroma_acts
321,6,90.51733333333333,137.0773333333333,46.55999999999999,189,286,97,4,chroma_acts
321,7,137.0773333333333,150.5173333333333,13.439999999999998,286,314,28,4,chroma_acts
321,8,150.5173333333333,198.141,47.62366666666668,314,412,98,4,chroma_acts
324,1,0.0,31.33866666666667,31.33866666666667,0,64,64,5,chroma_acts
324,2,31.33866666666667,79.424,48.08533333333334,64,162,98,5,chroma_acts
324,3,79.424,94.63466666666667,15.210666666666668,162,193,31,5,chroma_acts
324,4,94.63466666666667,134.86933333333334,40.23466666666667,193,275,82,5,chroma_acts
324,5,134.86933333333334,176.576,41.70666666666665,275,360,85,5,chroma_acts
324,6,176.576,182.95466666666667,6.378666666666675,360,373,13,5,chroma_acts
324,7,182.95466666666667,184.91733333333335,1.9626666666666779,373,377,4,5,chroma_acts
324,8,184.91733333333335,235.714,50.79666666666665,377,479,102,5,chroma_acts
326,1,0.0,32.44799999999999,32.44799999999999,0,68,68,4,chroma_acts
326,2,32.44799999999999,73.24799999999999,40.8,68,153,85,4,chroma_acts
326,3,73.24799999999999,93.88799999999999,20.64,153,196,43,4,chroma_acts
326,4,93.88799999999999,123.648,29.760000000000005,196,258,62,4,chroma_acts
326,5,123.648,148.12800000000001,24.480000000000018,258,309,51,4,chroma_acts
326,6,148.12800000000001,151.488,3.359999999999985,309,316,7,4,chroma_acts
326,7,151.488,170.68800000000002,19.200000000000017,316,356,40,4,chroma_acts
326,8,170.68800000000002,203.54,32.851999999999975,356,423,67,4,chroma_acts
327,1,0.0,26.901333333333334,26.901333333333334,0,57,57,5,chroma_acts
327,2,26.901333333333334,29.301333333333332,2.3999999999999986,57,62,5,5,chroma_acts
327,3,29.301333333333332,69.14133333333334,39.84,62,145,83,5,chroma_acts
327,4,69.14133333333334,75.38133333333333,6.239999999999995,145,158,13,5,chroma_acts
327,5,75.38133333333333,92.18133333333333,16.799999999999997,158,193,35,5,chroma_acts
327,6,92.18133333333333,121.46133333333333,29.28,193,254,61,5,chroma_acts
327,7,121.46133333333333,156.218,34.75666666666666,254,325,71,5,chroma_acts
328,1,0.0,28.650666666666666,28.650666666666666,0,60,60,4,chroma_acts
328,2,28.650666666666666,31.050666666666665,2.3999999999999986,60,65,5,4,chroma_acts
328,3,31.050666666666665,44.010666666666665,12.96,65,92,27,4,chroma_acts
328,4,44.010666666666665,45.93066666666667,1.9200000000000017,92,96,4,4,chroma_acts
328,5,45.93066666666667,59.370666666666665,13.439999999999998,96,124,28,4,chroma_acts
328,6,59.370666666666665,92.49066666666667,33.120000000000005,124,193,69,4,chroma_acts
328,7,92.49066666666667,96.33066666666667,3.8400000000000034,193,201,8,4,chroma_acts
328,8,96.33066666666667,100.17066666666668,3.8400000000000034,201,209,8,4,chroma_acts
328,9,100.17066666666668,131.561,31.39033333333333,209,273,64,4,chroma_acts
329,1,0.0,14.826666666666666,14.826666666666666,0,32,32,4,chroma_acts
329,2,14.826666666666666,19.050666666666668,4.224000000000002,32,41,9,4,chroma_acts
329,3,19.050666666666668,29.845333333333333,10.794666666666664,41,64,23,4,chroma_acts
329,4,29.845333333333333,34.06933333333333,4.224,64,73,9,4,chroma_acts
329,5,34.06933333333333,43.92533333333333,9.855999999999995,73,94,21,4,chroma_acts
329,6,43.92533333333333,107.75466666666667,63.82933333333334,94,230,136,4,chroma_acts
329,7,107.75466666666667,149.99466666666666,42.239999999999995,230,320,90,4,chroma_acts
329,8,149.99466666666666,225.55733333333333,75.56266666666667,320,481,161,4,chroma_acts
329,9,225.55733333333333,244.858,19.30066666666667,481,521,40,4,chroma_acts
331,1,0.0,3.861333333333333,3.861333333333333,0,9,9,4,chroma_acts
331,2,3.861333333333333,41.408,37.54666666666667,9,89,80,4,chroma_acts
331,3,41.408,45.16266666666667,3.7546666666666653,89,97,8,4,chroma_acts
331,4,45.16266666666667,48.91733333333333,3.7546666666666653,97,105,8,4,chroma_acts
331,5,48.91733333333333,81.77066666666667,32.85333333333334,105,175,70,4,chroma_acts
331,6,81.77066666666667,97.728,15.957333333333324,175,209,34,4,chroma_acts
331,7,97.728,101.48266666666667,3.7546666666666795,209,217,8,4,chroma_acts
331,8,101.48266666666667,127.76533333333333,26.282666666666657,217,273,56,4,chroma_acts
331,9,127.76533333333333,159.576,31.810666666666663,273,339,66,4,chroma_acts
334,1,0.0,36.96,36.96,0,73,73,4,chroma_acts
334,2,36.96,55.391999999999996,18.431999999999995,73,109,36,4,chroma_acts
334,3,55.391999999999996,118.88000000000001,63.488000000000014,109,233,124,4,chroma_acts
334,4,118.88000000000001,122.976,4.095999999999989,233,241,8,4,chroma_acts
334,5,122.976,137.824,14.848000000000013,241,270,29,4,chroma_acts
334,6,137.824,172.12800000000001,34.304,270,337,67,4,chroma_acts
334,7,172.12800000000001,206.43200000000002,34.304,337,404,67,4,chroma_acts
334,8,206.43200000000002,239.71200000000002,33.28,404,469,65,4,chroma_acts
334,9,239.71200000000002,256.792,17.079999999999956,469,501,32,4,chroma_acts
336,1,0.0,7.669333333333333,7.669333333333333,0,11,11,5,chroma_acts
336,2,7.669333333333333,52.693333333333335,45.024,11,74,63,5,chroma_acts
336,3,52.693333333333335,84.13866666666667,31.44533333333333,74,118,44,5,chroma_acts
336,4,84.13866666666667,91.28533333333333,7.146666666666661,118,128,10,5,chroma_acts
336,5,91.28533333333333,99.14666666666666,7.861333333333334,128,139,11,5,chroma_acts
336,6,99.14666666666666,130.592,31.445333333333352,139,183,44,5,chroma_acts
336,7,130.592,144.17066666666668,13.578666666666663,183,202,19,5,chroma_acts
336,8,144.17066666666668,193.648,49.47733333333332,202,270,68,5,chroma_acts
341,1,0.0,31.200000000000003,31.200000000000003,0,64,64,6,chroma_acts
341,2,31.200000000000003,94.00533333333334,62.80533333333334,64,192,128,6,chroma_acts
341,3,94.00533333333334,127.86133333333333,33.855999999999995,192,261,69,6,chroma_acts
341,4,127.86133333333333,157.30133333333336,29.440000000000026,261,321,60,6,chroma_acts
341,5,157.30133333333336,187.23200000000003,29.930666666666667,321,382,61,6,chroma_acts
341,6,187.23200000000003,188.704,1.47199999999998,382,385,3,6,chroma_acts
341,7,188.704,267.70133333333337,78.99733333333336,385,546,161,6,chroma_acts
341,8,267.70133333333337,285.509,17.80766666666665,546,581,35,6,chroma_acts
347,1,0.0,3.936,3.936,0,9,9,4,chroma_acts
347,2,3.936,62.495999999999995,58.559999999999995,9,131,122,4,chroma_acts
347,3,62.495999999999995,64.416,1.9200000000000017,131,135,4,4,chroma_acts
347,4,64.416,93.21600000000001,28.80000000000001,135,195,60,4,chroma_acts
347,5,93.21600000000001,96.096,2.8799999999999955,195,201,6,4,chroma_acts
347,6,96.096,112.416,16.319999999999993,201,235,34,4,chroma_acts
347,7,112.416,123.936,11.52000000000001,235,259,24,4,chroma_acts
347,8,123.936,125.856,1.9199999999999875,259,263,4,4,chroma_acts
347,9,125.856,173.521,47.66499999999999,263,361,98,4,chroma_acts
348,1,0.0,14.602666666666666,14.602666666666666,0,32,32,5,chroma_acts
348,2,14.602666666666666,48.864,34.26133333333333,32,105,73,5,chroma_acts
348,3,48.864,58.25066666666667,9.38666666666667,105,125,20,5,chroma_acts
348,4,58.25066666666667,89.696,31.44533333333333,125,192,67,5,chroma_acts
348,5,89.696,105.184,15.488,192,225,33,5,chroma_acts
348,6,105.184,108.93866666666666,3.7546666666666653,225,233,8,5,chroma_acts
348,7,108.93866666666666,121.61066666666666,12.671999999999997,233,260,27,5,chroma_acts
348,8,121.61066666666666,165.25866666666667,43.64800000000001,260,353,93,5,chroma_acts
348,9,165.25866666666667,180.0,14.74133333333333,353,383,30,5,chroma_acts
349,1,0.0,57.16266666666667,57.16266666666667,0,120,120,5,chroma_acts
349,2,57.16266666666667,60.522666666666666,3.3599999999999994,120,127,7,5,chroma_acts
349,3,60.522666666666666,64.84266666666666,4.319999999999993,127,136,9,5,chroma_acts
349,4,64.84266666666666,68.20266666666666,3.3599999999999994,136,143,7,5,chroma_acts
349,5,68.20266666666666,72.52266666666667,4.320000000000007,143,152,9,5,chroma_acts
349,6,72.52266666666667,75.88266666666667,3.3599999999999994,152,159,7,5,chroma_acts
349,7,75.88266666666667,80.20266666666666,4.319999999999993,159,168,9,5,chroma_acts
349,8,80.20266666666666,98.92266666666666,18.72,168,207,39,5,chroma_acts
349,9,98.92266666666666,175.038,76.11533333333335,207,364,157,5,chroma_acts
350,1,0.0,22.88,22.88,0,48,48,5,chroma_acts
350,2,22.88,61.28,38.400000000000006,48,128,80,5,chroma_acts
350,3,61.28,108.32,47.03999999999999,128,226,98,5,chroma_acts
350,4,108.32,123.67999999999999,15.36,226,258,32,5,chroma_acts
350,5,123.67999999999999,153.92,30.239999999999995,258,321,63,5,chroma_acts
350,6,153.92,185.6,31.680000000000007,321,387,66,5,chroma_acts
350,7,185.6,200.95999999999998,15.359999999999985,387,419,32,5,chroma_acts
350,8,200.95999999999998,231.67999999999998,30.72,419,483,64,5,chroma_acts
350,9,231.67999999999998,263.226,31.54600000000002,483,547,64,5,chroma_acts
351,1,0.0,3.6266666666666665,3.6266666666666665,0,8,8,3,chroma_acts
351,2,3.6266666666666665,19.466666666666665,15.839999999999998,8,41,33,3,chroma_acts
351,3,19.466666666666665,32.42666666666666,12.959999999999997,41,68,27,3,chroma_acts
351,4,32.42666666666666,34.346666666666664,1.9200000000000017,68,72,4,3,chroma_acts
351,5,34.346666666666664,79.94666666666666,45.599999999999994,72,167,95,3,chroma_acts
351,6,79.94666666666666,111.62666666666667,31.680000000000007,167,233,66,3,chroma_acts
351,7,111.62666666666667,125.54666666666667,13.920000000000002,233,262,29,3,chroma_acts
351,8,125.54666666666667,175.632,50.08533333333334,262,365,103,3,chroma_acts
352,1,0.0,30.634666666666664,30.634666666666664,0,64,64,5,chroma_acts
352,2,30.634666666666664,38.794666666666664,8.16,64,81,17,5,chroma_acts
352,3,38.794666666666664,46.474666666666664,7.68,81,97,16,5,chroma_acts
352,4,46.474666666666664,93.03466666666667,46.56,97,194,97,5,chroma_acts
352,5,93.03466666666667,101.19466666666666,8.159999999999997,194,211,17,5,chroma_acts
352,6,101.19466666666666,123.75466666666667,22.560000000000002,211,258,47,5,chroma_acts
352,7,123.75466666666667,139.11466666666666,15.36,258,290,32,5,chroma_acts
352,8,139.11466666666666,175.59466666666665,36.47999999999999,290,366,76,5,chroma_acts
352,9,175.59466666666665,218.71,43.11533333333335,366,454,88,5,chroma_acts
353,1,0.0,29.343999999999998,29.343999999999998,0,62,62,3,chroma_acts
353,2,29.343999999999998,46.623999999999995,17.279999999999998,62,98,36,3,chroma_acts
353,3,46.623999999999995,75.904,29.28,98,159,61,3,chroma_acts
353,4,75.904,93.184,17.28,159,195,36,3,chroma_acts
353,5,93.184,123.904,30.72,195,259,64,3,chroma_acts
353,6,123.904,139.744,15.840000000000003,259,292,33,3,chroma_acts
353,7,139.744,155.104,15.360000000000014,292,324,32,3,chroma_acts
353,8,155.104,199.744,44.639999999999986,324,417,93,3,chroma_acts
353,9,199.744,217.667,17.923000000000002,417,453,36,3,chroma_acts
354,1,0.0,17.642666666666667,17.642666666666667,0,37,37,5,chroma_acts
354,2,17.642666666666667,46.922666666666665,29.279999999999998,37,98,61,5,chroma_acts
354,3,46.922666666666665,56.522666666666666,9.600000000000001,98,118,20,5,chroma_acts
354,4,56.522666666666666,63.72266666666666,7.199999999999996,118,133,15,5,chroma_acts
354,5,63.72266666666666,93.00266666666667,29.28000000000001,133,194,61,5,chroma_acts
354,6,93.00266666666667,107.88266666666667,14.879999999999995,194,225,31,5,chroma_acts
354,7,107.88266666666667,125.16266666666667,17.28,225,261,36,5,chroma_acts
354,8,125.16266666666667,158.116,32.95333333333335,261,328,67,5,chroma_acts
355,1,0.0,15.989333333333333,15.989333333333333,0,35,35,4,chroma_acts
355,2,15.989333333333333,27.253333333333334,11.264000000000001,35,59,24,4,chroma_acts
355,3,27.253333333333334,30.069333333333333,2.815999999999999,59,65,6,4,chroma_acts
355,4,30.069333333333333,61.04533333333333,30.976,65,131,66,4,chroma_acts
355,5,61.04533333333333,75.59466666666667,14.549333333333337,131,162,31,4,chroma_acts
355,6,75.59466666666667,120.18133333333333,44.58666666666666,162,257,95,4,chroma_acts
355,7,120.18133333333333,143.17866666666666,22.99733333333333,257,306,49,4,chroma_acts
355,8,143.17866666666666,150.21866666666665,7.039999999999992,306,321,15,4,chroma_acts
355,9,150.21866666666665,191.179,40.96033333333335,321,407,86,4,chroma_acts
356,1,0.0,17.866666666666667,17.866666666666667,0,39,39,4,chroma_acts
356,2,17.866666666666667,31.008000000000003,13.141333333333336,39,67,28,4,chroma_acts
356,3,31.008000000000003,59.63733333333333,28.629333333333328,67,128,61,4,chroma_acts
356,4,59.63733333333333,76.06400000000001,16.426666666666677,128,163,35,4,chroma_acts
356,5,76.06400000000001,106.57066666666667,30.50666666666666,163,228,65,4,chroma_acts
356,6,106.57066666666667,126.752,20.181333333333328,228,271,43,4,chroma_acts
356,7,126.752,144.1173333333333,17.36533333333331,271,308,37,4,chroma_acts
356,8,144.1173333333333,158.66666666666666,14.549333333333351,308,339,31,4,chroma_acts
356,9,158.66666666666666,190.781,32.11433333333335,339,406,67,4,chroma_acts
357,1,0.0,32.266666666666666,32.266666666666666,0,68,68,4,chroma_acts
357,2,32.266666666666666,77.38666666666667,45.120000000000005,68,162,94,4,chroma_acts
357,3,77.38666666666667,78.34666666666666,0.9599999999999937,162,164,2,4,chroma_acts
357,4,78.34666666666666,93.22666666666666,14.879999999999995,164,195,31,4,chroma_acts
357,5,93.22666666666666,125.86666666666666,32.64,195,263,68,4,chroma_acts
357,6,125.86666666666666,138.34666666666666,12.480000000000004,263,289,26,4,chroma_acts
357,7,138.34666666666666,140.74666666666664,2.3999999999999773,289,294,5,4,chroma_acts
357,8,140.74666666666664,189.274,48.52733333333336,294,394,100,4,chroma_acts
358,1,0.0,15.061333333333334,15.061333333333334,0,33,33,4,chroma_acts
358,2,15.061333333333334,28.202666666666666,13.141333333333332,33,61,28,4,chroma_acts
358,3,28.202666666666666,60.586666666666666,32.384,61,130,69,4,chroma_acts
358,4,60.586666666666666,74.66666666666667,14.080000000000005,130,160,30,4,chroma_acts
358,5,74.66666666666667,105.64266666666667,30.976,160,226,66,4,chroma_acts
358,6,105.64266666666667,142.72,37.07733333333333,226,305,79,4,chroma_acts
358,7,142.72,149.76,7.039999999999992,305,320,15,4,chroma_acts
358,8,149.76,172.75733333333332,22.99733333333333,320,369,49,4,chroma_acts
358,9,172.75733333333332,180.805,8.047666666666686,369,385,16,4,chroma_acts
360,1,0.0,4.672,4.672,0,10,10,5,chroma_acts
360,2,4.672,15.701333333333332,11.029333333333334,10,32,22,5,chroma_acts
360,3,15.701333333333332,65.83466666666666,50.13333333333333,32,132,100,5,chroma_acts
360,4,65.83466666666666,109.95199999999998,44.11733333333332,132,220,88,5,chroma_acts
360,5,109.95199999999998,112.96,3.0080000000000098,220,226,6,5,chroma_acts
360,6,112.96,116.46933333333332,3.5093333333333305,226,233,7,5,chroma_acts
360,7,116.46933333333332,172.306,55.83666666666669,233,343,110,5,chroma_acts
362,1,0.0,31.146666666666665,31.146666666666665,0,63,63,5,chroma_acts
362,2,31.146666666666665,76.76799999999999,45.621333333333325,63,154,91,5,chroma_acts
362,3,76.76799999999999,79.77599999999998,3.0079999999999956,154,160,6,5,chroma_acts
362,4,79.77599999999998,174.02666666666667,94.25066666666669,160,348,188,5,chroma_acts
362,5,174.02666666666667,188.064,14.037333333333322,348,376,28,5,chroma_acts
362,6,188.064,191.57333333333332,3.5093333333333305,376,383,7,5,chroma_acts
362,7,191.57333333333332,195.584,4.01066666666668,383,391,8,5,chroma_acts
362,8,195.584,223.65866666666665,28.074666666666644,391,447,56,5,chroma_acts
362,9,223.65866666666665,272.472,48.81333333333333,447,543,96,5,chroma_acts
363,1,0.0,9.376000000000001,9.376000000000001,0,20,20,5,chroma_acts
363,2,9.376000000000001,29.493333333333336,20.117333333333335,20,61,41,5,chroma_acts
363,3,29.493333333333336,62.368,32.87466666666667,61,128,67,5,chroma_acts
363,4,62.368,96.71466666666667,34.34666666666667,128,198,70,5,chroma_acts
363,5,96.71466666666667,130.57066666666668,33.85600000000001,198,267,69,5,chroma_acts
363,6,130.57066666666668,160.50133333333335,29.930666666666667,267,328,61,5,chroma_acts
363,7,160.50133333333335,166.38933333333335,5.888000000000005,328,340,12,5,chroma_acts
363,8,166.38933333333335,206.13333333333335,39.744,340,421,81,5,chroma_acts
363,9,206.13333333333335,221.726,15.592666666666645,421,451,30,5,chroma_acts
366,1,0.0,16.81066666666667,16.81066666666667,0,38,38,5,chroma_acts
366,2,16.81066666666667,29.80266666666667,12.992,38,67,29,5,chroma_acts
366,3,29.80266666666667,72.81066666666668,43.00800000000001,67,163,96,5,chroma_acts
366,4,72.81066666666668,77.29066666666668,4.480000000000004,163,173,10,5,chroma_acts
366,5,77.29066666666668,88.93866666666668,11.647999999999996,173,199,26,5,chroma_acts
366,6,88.93866666666668,105.51466666666668,16.576000000000008,199,236,37,5,chroma_acts
366,7,105.51466666666668,130.15466666666669,24.64,236,291,55,5,chroma_acts
366,8,130.15466666666669,163.623,33.468333333333305,291,364,73,5,chroma_acts
367,1,0.0,6.837333333333334,6.837333333333334,0,16,16,3,chroma_acts
367,2,6.837333333333334,21.62133333333334,14.784000000000006,16,49,33,3,chroma_acts
367,3,21.62133333333334,35.50933333333334,13.887999999999998,49,80,31,3,chroma_acts
367,4,35.50933333333334,63.73333333333334,28.224000000000004,80,143,63,3,chroma_acts
367,5,63.73333333333334,100.46933333333335,36.73600000000001,143,225,82,3,chroma_acts
367,6,100.46933333333335,103.60533333333335,3.1359999999999957,225,232,7,3,chroma_acts
367,7,103.60533333333335,107.18933333333335,3.584000000000003,232,240,8,3,chroma_acts
367,8,107.18933333333335,150.448,43.258666666666656,240,335,95,3,chroma_acts
368,1,0.0,7.712,7.712,0,17,17,6,chroma_acts
368,2,7.712,21.152,13.440000000000001,17,45,28,6,chroma_acts
368,3,21.152,53.792,32.64,45,113,68,6,chroma_acts
368,4,53.792,57.152,3.3599999999999994,113,120,7,6,chroma_acts
368,5,57.152,113.312,56.16,120,237,117,6,chroma_acts
368,6,113.312,145.952,32.64,237,305,68,6,chroma_acts
368,7,145.952,172.352,26.400000000000006,305,360,55,6,chroma_acts
368,8,172.352,210.733,38.381,360,438,78,6,chroma_acts
370,1,0.0,31.605333333333334,31.605333333333334,0,66,66,4,chroma_acts
370,2,31.605333333333334,62.80533333333333,31.199999999999996,66,131,65,4,chroma_acts
370,3,62.80533333333333,94.00533333333333,31.199999999999996,131,196,65,4,chroma_acts
370,4,94.00533333333333,132.88533333333334,38.88000000000001,196,277,81,4,chroma_acts
370,5,132.88533333333334,159.76533333333333,26.879999999999995,277,333,56,4,chroma_acts
370,6,159.76533333333333,202.48533333333333,42.72,333,422,89,4,chroma_acts
370,7,202.48533333333333,217.84533333333334,15.360000000000014,422,454,32,4,chroma_acts
370,8,217.84533333333334,279.76533333333333,61.91999999999999,454,583,129,4,chroma_acts
370,9,279.76533333333333,296.045,16.279666666666685,583,615,32,4,chroma_acts
371,1,0.0,14.687999999999999,14.687999999999999,0,31,31,7,chroma_acts
371,2,14.687999999999999,46.848,32.16,31,98,67,7,chroma_acts
371,3,46.848,93.408,46.56,98,195,97,7,chroma_acts
371,4,93.408,98.208,4.799999999999997,195,205,10,7,chroma_acts
371,5,98.208,131.808,33.599999999999994,205,275,70,7,chroma_acts
371,6,131.808,135.648,3.8400000000000034,275,283,8,7,chroma_acts
371,7,135.648,139.00799999999998,3.359999999999985,283,290,7,7,chroma_acts
371,8,139.00799999999998,186.018,47.01000000000002,290,386,96,7,chroma_acts
372,1,0.0,5.578666666666666,5.578666666666666,0,13,13,4,chroma_acts
372,2,5.578666666666666,14.751999999999999,9.173333333333332,13,33,20,4,chroma_acts
372,3,14.751999999999999,42.730666666666664,27.978666666666665,33,94,61,4,chroma_acts
372,4,42.730666666666664,72.08533333333332,29.35466666666666,94,158,64,4,chroma_acts
372,5,72.08533333333332,105.10933333333331,33.02399999999999,158,230,72,4,chroma_acts
372,6,105.10933333333331,120.24533333333332,15.13600000000001,230,263,33,4,chroma_acts
372,7,120.24533333333332,127.12533333333332,6.8799999999999955,263,278,15,4,chroma_acts
372,8,127.12533333333332,164.27733333333333,37.152000000000015,278,359,81,4,chroma_acts
372,9,164.27733333333333,193.913,29.63566666666668,359,422,63,4,chroma_acts
374,1,0.0,30.005333333333333,30.005333333333333,0,63,63,5,chroma_acts
374,2,30.005333333333333,59.76533333333333,29.759999999999998,63,125,62,5,chroma_acts
374,3,59.76533333333333,62.64533333333333,2.8800000000000026,125,131,6,5,chroma_acts
374,4,62.64533333333333,66.96533333333333,4.32,131,140,9,5,chroma_acts
374,5,66.96533333333333,70.32533333333333,3.3599999999999994,140,147,7,5,chroma_acts
374,6,70.32533333333333,74.16533333333334,3.8400000000000034,147,155,8,5,chroma_acts
374,7,74.16533333333334,93.36533333333334,19.200000000000003,155,195,40,5,chroma_acts
374,8,93.36533333333334,121.887,28.52166666666666,195,253,58,5,chroma_acts
375,1,0.0,17.376,17.376,0,38,38,4,chroma_acts
375,2,17.376,35.72266666666666,18.34666666666666,38,78,40,4,chroma_acts
375,3,35.72266666666666,75.16799999999999,39.44533333333333,78,164,86,4,chroma_acts
375,4,75.16799999999999,93.97333333333331,18.805333333333323,164,205,41,4,chroma_acts
375,5,93.97333333333331,105.43999999999998,11.466666666666669,205,230,25,4,chroma_acts
375,6,105.43999999999998,109.10933333333332,3.6693333333333413,230,238,8,4,chroma_acts
375,7,109.10933333333332,121.49333333333331,12.383999999999986,238,265,27,4,chroma_acts
375,8,121.49333333333331,123.32799999999999,1.8346666666666778,265,269,4,4,chroma_acts
375,9,123.32799999999999,154.177,30.849000000000004,269,335,66,4,chroma_acts
388,1,0.0,16.362666666666666,16.362666666666666,0,35,35,5,chroma_acts
388,2,16.362666666666666,66.28266666666667,49.92,35,139,104,5,chroma_acts
388,3,66.28266666666667,69.64266666666667,3.3599999999999994,139,146,7,5,chroma_acts
388,4,69.64266666666667,73.48266666666667,3.8400000000000034,146,154,8,5,chroma_acts
388,5,73.48266666666667,77.32266666666666,3.839999999999989,154,162,8,5,chroma_acts
388,6,77.32266666666666,80.68266666666666,3.3599999999999994,162,169,7,5,chroma_acts
388,7,80.68266666666666,92.68266666666666,12.0,169,194,25,5,chroma_acts
388,8,92.68266666666666,115.24266666666666,22.560000000000002,194,241,47,5,chroma_acts
388,9,115.24266666666666,146.795,31.552333333333323,241,305,64,5,chroma_acts
389,1,0.0,11.306666666666667,11.306666666666667,0,24,24,5,chroma_acts
389,2,11.306666666666667,15.146666666666667,3.84,24,32,8,5,chroma_acts
389,3,15.146666666666667,63.626666666666665,48.48,32,133,101,5,chroma_acts
389,4,63.626666666666665,98.18666666666667,34.56,133,205,72,5,chroma_acts
389,5,98.18666666666667,102.98666666666665,4.799999999999983,205,215,10,5,chroma_acts
389,6,102.98666666666665,103.94666666666666,0.960000000000008,215,217,2,5,chroma_acts
389,7,103.94666666666666,111.62666666666667,7.680000000000007,217,233,16,5,chroma_acts
389,8,111.62666666666667,114.50666666666666,2.8799999999999955,233,239,6,5,chroma_acts
389,9,114.50666666666666,191.429,76.92233333333334,239,398,159,5,chroma_acts
393,1,0.0,48.416,48.416,0,106,106,5,chroma_acts
393,2,48.416,64.928,16.512,106,142,36,5,chroma_acts
393,3,64.928,72.26666666666665,7.338666666666654,142,158,16,5,chroma_acts
393,4,72.26666666666665,75.93599999999999,3.6693333333333413,158,166,8,5,chroma_acts
393,5,75.93599999999999,104.37333333333332,28.437333333333328,166,228,62,5,chroma_acts
393,6,104.37333333333332,132.81066666666666,28.437333333333342,228,290,62,5,chroma_acts
393,7,132.81066666666666,147.48799999999997,14.677333333333308,290,322,32,5,chroma_acts
393,8,147.48799999999997,176.384,28.896000000000015,322,385,63,5,chroma_acts
393,9,176.384,212.499,36.11500000000001,385,462,77,5,chroma_acts
397,1,0.0,15.093333333333334,15.093333333333334,0,32,32,5,chroma_acts
397,2,15.093333333333334,45.81333333333333,30.72,32,96,64,5,chroma_acts
397,3,45.81333333333333,93.81333333333333,48.0,96,196,100,5,chroma_acts
397,4,93.81333333333333,108.69333333333333,14.879999999999995,196,227,31,5,chroma_acts
397,5,108.69333333333333,112.53333333333333,3.8400000000000034,227,235,8,5,chroma_acts
397,6,112.53333333333333,116.37333333333333,3.8400000000000034,235,243,8,5,chroma_acts
397,7,116.37333333333333,122.13333333333333,5.759999999999991,243,255,12,5,chroma_acts
397,8,122.13333333333333,201.472,79.33866666666668,255,419,164,5,chroma_acts
399,1,0.0,48.330666666666666,48.330666666666666,0,97,97,5,chroma_acts
399,2,48.330666666666666,63.87199999999999,15.541333333333327,97,128,31,5,chroma_acts
399,3,63.87199999999999,91.94666666666667,28.07466666666668,128,184,56,5,chroma_acts
399,4,91.94666666666667,95.95733333333334,4.0106666666666655,184,192,8,5,chroma_acts
399,5,95.95733333333334,124.032,28.07466666666666,192,248,56,5,chroma_acts
399,6,124.032,142.07999999999998,18.047999999999988,248,284,36,5,chroma_acts
399,7,142.07999999999998,168.14933333333332,26.069333333333333,284,336,52,5,chroma_acts
399,8,168.14933333333332,266.815,98.66566666666668,336,531,195,5,chroma_acts
400,1,0.0,9.408,9.408,0,20,20,5,chroma_acts
400,2,9.408,53.568,44.16,20,112,92,5,chroma_acts
400,3,53.568,99.648,46.08,112,208,96,5,chroma_acts
400,4,99.648,130.368,30.72,208,272,64,5,chroma_acts
400,5,130.368,161.088,30.72,272,336,64,5,chroma_acts
400,6,161.088,175.008,13.920000000000016,336,365,29,5,chroma_acts
400,7,175.008,176.448,1.4399999999999977,365,368,3,5,chroma_acts
400,8,176.448,190.368,13.919999999999987,368,397,29,5,chroma_acts
400,9,190.368,209.068,18.700000000000017,397,434,37,5,chroma_acts
401,1,0.0,19.264,19.264,0,41,41,4,chroma_acts
401,2,19.264,23.104,3.84,41,49,8,4,chroma_acts
401,3,23.104,26.944,3.84,49,57,8,4,chroma_acts
401,4,26.944,61.504,34.56,57,129,72,4,chroma_acts
401,5,61.504,65.344,3.8399999999999963,129,137,8,4,chroma_acts
401,6,65.344,69.184,3.8400000000000034,137,145,8,4,chroma_acts
401,7,69.184,96.064,26.879999999999995,145,201,56,4,chroma_acts
401,8,96.064,103.744,7.680000000000007,201,217,16,4,chroma_acts
401,9,103.744,141.239,37.495000000000005,217,294,77,4,chroma_acts
403,1,0.0,5.4079999999999995,5.4079999999999995,0,12,12,5,chroma_acts
403,2,5.4079999999999995,8.288,2.880000000000001,12,18,6,5,chroma_acts
403,3,8.288,38.528,30.24,18,81,63,5,chroma_acts
403,4,38.528,100.928,62.4,81,211,130,5,chroma_acts
403,5,100.928,133.088,32.16,211,278,67,5,chroma_acts
403,6,133.088,136.448,3.3600000000000136,278,285,7,5,chroma_acts
403,7,136.448,141.248,4.799999999999983,285,295,10,5,chroma_acts
403,8,141.248,162.84799999999998,21.599999999999994,295,340,45,5,chroma_acts
403,9,162.84799999999998,178.84,15.992000000000019,340,372,32,5,chroma_acts
405,1,0.0,43.541333333333334,43.541333333333334,0,81,81,4,chroma_acts
405,2,43.541333333333334,62.58133333333333,19.04,81,116,35,4,chroma_acts
405,3,62.58133333333333,97.94133333333333,35.36,116,181,65,4,chroma_acts
405,4,97.94133333333333,103.38133333333334,5.440000000000012,181,191,10,4,chroma_acts
405,5,103.38133333333334,113.17333333333335,9.792000000000002,191,209,18,4,chroma_acts
405,6,113.17333333333335,163.76533333333336,50.59200000000001,209,302,93,4,chroma_acts
405,7,163.76533333333336,182.26133333333337,18.49600000000001,302,336,34,4,chroma_acts
405,8,182.26133333333337,227.393,45.13166666666663,336,417,81,4,chroma_acts
407,1,0.0,17.962666666666664,17.962666666666664,0,32,32,4,chroma_acts
407,2,17.962666666666664,41.00266666666666,23.04,32,72,40,4,chroma_acts
407,3,41.00266666666666,55.97866666666666,14.975999999999999,72,98,26,4,chroma_acts
407,4,55.97866666666666,73.25866666666667,17.28000000000001,98,128,30,4,chroma_acts
407,5,73.25866666666667,111.27466666666666,38.01599999999999,128,194,66,4,chroma_acts
407,6,111.27466666666666,132.58666666666664,21.311999999999983,194,231,37,4,chroma_acts
407,7,132.58666666666664,146.41066666666666,13.824000000000012,231,255,24,4,chroma_acts
407,8,146.41066666666666,219.56266666666664,73.15199999999999,255,382,127,4,chroma_acts
407,9,219.56266666666664,237.714,18.151333333333355,382,412,30,4,chroma_acts
410,1,0.0,13.482666666666667,13.482666666666667,0,29,29,5,chroma_acts
410,2,13.482666666666667,16.362666666666666,2.879999999999999,29,35,6,5,chroma_acts
410,3,16.362666666666666,42.76266666666667,26.400000000000002,35,90,55,5,chroma_acts
410,4,42.76266666666667,46.12266666666667,3.3599999999999994,90,97,7,5,chroma_acts
410,5,46.12266666666667,77.32266666666666,31.199999999999996,97,162,65,5,chroma_acts
410,6,77.32266666666666,112.36266666666666,35.03999999999999,162,235,73,5,chroma_acts
410,7,112.36266666666666,116.20266666666666,3.8400000000000034,235,243,8,5,chroma_acts
410,8,116.20266666666666,149.582,33.379333333333335,243,311,68,5,chroma_acts
412,1,0.0,18.741333333333333,18.741333333333333,0,40,40,4,chroma_acts
412,2,18.741333333333333,125.78133333333334,107.04,40,263,223,4,chroma_acts
412,3,125.78133333333334,137.3013333333333,11.519999999999968,263,287,24,4,chroma_acts
412,4,137.3013333333333,140.66133333333332,3.3600000000000136,287,294,7,4,chroma_acts
412,5,140.66133333333332,144.50133333333332,3.8400000000000034,294,302,8,4,chroma_acts
412,6,144.50133333333332,148.34133333333332,3.8400000000000034,302,310,8,4,chroma_acts
412,7,148.34133333333332,152.18133333333333,3.8400000000000034,310,318,8,4,chroma_acts
412,8,152.18133333333333,156.0213333333333,3.839999999999975,318,326,8,4,chroma_acts
412,9,156.0213333333333,252.826,96.80466666666669,326,526,200,4,chroma_acts
413,1,0.0,5.834666666666667,5.834666666666667,0,10,10,4,chroma_acts
413,2,5.834666666666667,42.272000000000006,36.43733333333334,10,71,61,4,chroma_acts
413,3,42.272000000000006,53.024,10.751999999999995,71,89,18,4,chroma_acts
413,4,53.024,95.43466666666669,42.410666666666685,89,160,71,4,chroma_acts
413,5,95.43466666666669,131.872,36.43733333333333,160,221,61,4,chroma_acts
413,6,131.872,135.45600000000002,3.584000000000003,221,227,6,4,chroma_acts
413,7,135.45600000000002,164.12800000000001,28.671999999999997,227,275,48,4,chroma_acts
413,8,164.12800000000001,208.92800000000003,44.80000000000001,275,350,75,4,chroma_acts
413,9,208.92800000000003,224.074,15.145999999999987,350,374,24,4,chroma_acts
415,1,0.0,46.218666666666664,46.218666666666664,0,82,82,5,chroma_acts
415,2,46.218666666666664,59.78666666666667,13.568000000000005,82,106,24,5,chroma_acts
415,3,59.78666666666667,100.49066666666667,40.704,106,178,72,5,chroma_acts
415,4,100.49066666666667,133.28,32.78933333333333,178,236,58,5,chroma_acts
415,5,133.28,137.23733333333334,3.957333333333338,236,243,7,5,chroma_acts
415,6,137.23733333333334,150.80533333333335,13.568000000000012,243,267,24,5,chroma_acts
415,7,150.80533333333335,210.16533333333336,59.360000000000014,267,372,105,5,chroma_acts
415,8,210.16533333333336,228.82133333333334,18.655999999999977,372,405,33,5,chroma_acts
415,9,228.82133333333334,238.761,9.939666666666653,405,421,16,5,chroma_acts
416,1,0.0,14.656,14.656,0,32,32,4,chroma_acts
416,2,14.656,60.181333333333335,45.525333333333336,32,129,97,4,chroma_acts
416,3,60.181333333333335,64.40533333333333,4.223999999999997,129,138,9,4,chroma_acts
416,4,64.40533333333333,68.16,3.7546666666666653,138,146,8,4,chroma_acts
416,5,68.16,74.73066666666666,6.570666666666668,146,160,14,4,chroma_acts
416,6,74.73066666666666,78.95466666666667,4.224000000000004,160,169,9,4,chroma_acts
416,7,78.95466666666667,105.70666666666666,26.751999999999995,169,226,57,4,chroma_acts
416,8,105.70666666666666,117.44,11.733333333333334,226,251,25,4,chroma_acts
416,9,117.44,136.063,18.62299999999999,251,289,38,4,chroma_acts
418,1,0.0,3.8506666666666667,3.8506666666666667,0,9,9,4,chroma_acts
418,2,3.8506666666666667,6.730666666666666,2.8799999999999994,9,15,6,4,chroma_acts
418,3,6.730666666666666,11.530666666666667,4.800000000000001,15,25,10,4,chroma_acts
418,4,11.530666666666667,30.730666666666664,19.199999999999996,25,65,40,4,chroma_acts
418,5,30.730666666666664,91.21066666666665,60.47999999999999,65,191,126,4,chroma_acts
418,6,91.21066666666665,99.85066666666665,8.64,191,209,18,4,chroma_acts
418,7,99.85066666666665,132.757,32.90633333333335,209,276,67,4,chroma_acts
420,1,0.0,12.255999999999998,12.255999999999998,0,27,27,4,chroma_acts
420,2,12.255999999999998,20.234666666666666,7.978666666666667,27,44,17,4,chroma_acts
420,3,20.234666666666666,32.437333333333335,12.20266666666667,44,70,26,4,chroma_acts
420,4,32.437333333333335,78.432,45.99466666666667,70,168,98,4,chroma_acts
420,5,78.432,85.94133333333333,7.5093333333333305,168,184,16,4,chroma_acts
420,6,85.94133333333333,101.42933333333333,15.488,184,217,33,4,chroma_acts
420,7,101.42933333333333,114.57066666666667,13.141333333333336,217,245,28,4,chroma_acts
420,8,114.57066666666667,133.34400000000002,18.773333333333355,245,285,40,4,chroma_acts
420,9,133.34400000000002,179.278,45.93399999999997,285,381,96,4,chroma_acts
421,1,0.0,15.157333333333332,15.157333333333332,0,32,32,4,chroma_acts
421,2,15.157333333333332,30.517333333333333,15.360000000000001,32,64,32,4,chroma_acts
421,3,30.517333333333333,76.11733333333333,45.6,64,159,95,4,chroma_acts
421,4,76.11733333333333,91.47733333333333,15.36,159,191,32,4,chroma_acts
421,5,91.47733333333333,106.83733333333333,15.36,191,223,32,4,chroma_acts
421,6,106.83733333333333,123.63733333333333,16.799999999999997,223,258,35,4,chroma_acts
421,7,123.63733333333333,150.99733333333333,27.36,258,315,57,4,chroma_acts
421,8,150.99733333333333,167.31733333333332,16.319999999999993,315,349,34,4,chroma_acts
421,9,167.31733333333332,182.852,15.53466666666668,349,380,31,4,chroma_acts
422,1,0.0,14.197333333333333,14.197333333333333,0,30,30,5,chroma_acts
422,2,14.197333333333333,30.51733333333333,16.319999999999997,30,64,34,5,chroma_acts
422,3,30.51733333333333,78.03733333333334,47.52000000000001,64,163,99,5,chroma_acts
422,4,78.03733333333334,84.75733333333334,6.719999999999999,163,177,14,5,chroma_acts
422,5,84.75733333333334,105.87733333333334,21.120000000000005,177,221,44,5,chroma_acts
422,6,105.87733333333334,126.03733333333334,20.159999999999997,221,263,42,5,chroma_acts
422,7,126.03733333333334,149.07733333333334,23.040000000000006,263,311,48,5,chroma_acts
422,8,149.07733333333334,153.87733333333333,4.799999999999983,311,321,10,5,chroma_acts
422,9,153.87733333333333,170.766,16.888666666666666,321,355,34,5,chroma_acts
423,1,0.0,40.38399999999999,40.38399999999999,0,85,85,4,chroma_acts
423,2,40.38399999999999,44.224,3.8400000000000034,85,93,8,4,chroma_acts
423,3,44.224,92.22399999999999,47.99999999999999,93,193,100,4,chroma_acts
423,4,92.22399999999999,132.544,40.32000000000002,193,277,84,4,chroma_acts
423,5,132.544,184.38400000000001,51.84,277,385,108,4,chroma_acts
423,6,184.38400000000001,190.144,5.759999999999991,385,397,12,4,chroma_acts
423,7,190.144,192.064,1.9199999999999875,397,401,4,4,chroma_acts
423,8,192.064,199.691,7.6270000000000095,401,415,14,4,chroma_acts
424,1,0.0,28.608,28.608,0,60,60,4,chroma_acts
424,2,28.608,45.888,17.279999999999998,60,96,36,4,chroma_acts
424,3,45.888,85.24799999999999,39.35999999999999,96,178,82,4,chroma_acts
424,4,85.24799999999999,92.448,7.200000000000003,178,193,15,4,chroma_acts
424,5,92.448,120.76799999999999,28.319999999999993,193,252,59,4,chroma_acts
424,6,120.76799999999999,138.048,17.280000000000015,252,288,36,4,chroma_acts
424,7,138.048,177.40800000000002,39.360000000000014,288,370,82,4,chroma_acts
424,8,177.40800000000002,184.12800000000001,6.719999999999999,370,384,14,4,chroma_acts
424,9,184.12800000000001,199.895,15.766999999999996,384,415,31,4,chroma_acts
426,1,0.0,17.685333333333336,17.685333333333336,0,37,37,3,chroma_acts
426,2,17.685333333333336,28.245333333333335,10.559999999999999,37,59,22,3,chroma_acts
426,3,28.245333333333335,31.605333333333334,3.3599999999999994,59,66,7,3,chroma_acts
426,4,31.605333333333334,78.16533333333332,46.55999999999999,66,163,97,3,chroma_acts
426,5,78.16533333333332,93.04533333333333,14.88000000000001,163,194,31,3,chroma_acts
426,6,93.04533333333333,135.28533333333334,42.24000000000001,194,282,88,3,chroma_acts
426,7,135.28533333333334,138.16533333333334,2.8799999999999955,282,288,6,3,chroma_acts
426,8,138.16533333333334,185.405,47.239666666666665,288,385,97,3,chroma_acts
428,1,0.0,7.498666666666666,7.498666666666666,0,11,11,5,chroma_acts
428,2,7.498666666666666,24.671999999999997,17.173333333333332,11,34,23,5,chroma_acts
428,3,24.671999999999997,35.12533333333333,10.453333333333333,34,48,14,5,chroma_acts
428,4,35.12533333333333,53.04533333333333,17.92,48,72,24,5,chroma_acts
428,5,53.04533333333333,70.96533333333333,17.92,72,96,24,5,chroma_acts
428,6,70.96533333333333,104.56533333333333,33.599999999999994,96,141,45,5,chroma_acts
428,7,104.56533333333333,138.91199999999998,34.34666666666665,141,187,46,5,chroma_acts
428,8,138.91199999999998,175.739,36.82700000000003,187,235,48,5,chroma_acts
430,1,0.0,11.082666666666666,11.082666666666666,0,24,24,5,chroma_acts
430,2,11.082666666666666,31.264,20.181333333333335,24,67,43,5,chroma_acts
430,3,31.264,37.834666666666664,6.570666666666664,67,81,14,5,chroma_acts
430,4,37.834666666666664,55.66933333333333,17.834666666666664,81,119,38,5,chroma_acts
430,5,55.66933333333333,100.72533333333332,45.056,119,215,96,5,chroma_acts
430,6,100.72533333333332,129.35466666666667,28.62933333333335,215,276,61,5,chroma_acts
430,7,129.35466666666667,140.14933333333335,10.794666666666672,276,299,23,5,chroma_acts
430,8,140.14933333333335,173.186,33.03666666666666,299,368,69,5,chroma_acts
433,1,0.0,14.346666666666668,14.346666666666668,0,31,31,4,chroma_acts
433,2,14.346666666666668,48.608,34.261333333333326,31,104,73,4,chroma_acts
433,3,48.608,59.872,11.264000000000003,104,128,24,4,chroma_acts
433,4,59.872,89.90933333333334,30.037333333333336,128,192,64,4,chroma_acts
433,5,89.90933333333334,103.05066666666666,13.141333333333321,192,220,28,4,chroma_acts
433,6,103.05066666666666,109.62133333333333,6.570666666666668,220,234,14,4,chroma_acts
433,7,109.62133333333333,112.43733333333333,2.8160000000000025,234,240,6,4,chroma_acts
433,8,112.43733333333333,119.008,6.570666666666668,240,254,14,4,chroma_acts
433,9,119.008,180.144,61.13600000000001,254,383,129,4,chroma_acts
434,1,0.0,16.096,16.096,0,34,34,5,chroma_acts
434,2,16.096,34.816,18.720000000000002,34,73,39,5,chroma_acts
434,3,34.816,79.456,44.64,73,166,93,5,chroma_acts
434,4,79.456,99.136,19.679999999999993,166,207,41,5,chroma_acts
434,5,99.136,113.056,13.920000000000002,207,236,29,5,chroma_acts
434,6,113.056,143.77599999999998,30.719999999999985,236,300,64,5,chroma_acts
434,7,143.77599999999998,163.708,19.932000000000016,300,340,40,5,chroma_acts
436,1,0.0,14.495999999999999,14.495999999999999,0,31,31,5,chroma_acts
436,2,14.495999999999999,30.336,15.84,31,64,33,5,chroma_acts
436,3,30.336,44.25599999999999,13.919999999999995,64,93,29,5,chroma_acts
436,4,44.25599999999999,61.056,16.800000000000004,93,128,35,5,chroma_acts
436,5,61.056,104.736,43.68000000000001,128,219,91,5,chroma_acts
436,6,104.736,135.456,30.719999999999985,219,283,64,5,chroma_acts
436,7,135.456,136.896,1.4399999999999977,283,286,3,5,chroma_acts
436,8,136.896,187.053,50.15700000000001,286,389,103,5,chroma_acts
437,1,0.0,7.818666666666666,7.818666666666666,0,17,17,5,chroma_acts
437,2,7.818666666666666,38.32533333333333,30.506666666666668,17,82,65,5,chroma_acts
437,3,38.32533333333333,68.36266666666666,30.037333333333322,82,146,64,5,chroma_acts
437,4,68.36266666666666,83.38133333333333,15.018666666666675,146,178,32,5,chroma_acts
437,5,83.38133333333333,97.93066666666665,14.549333333333323,178,209,31,5,chroma_acts
437,6,97.93066666666665,134.06933333333333,36.13866666666668,209,286,77,5,chroma_acts
437,7,134.06933333333333,143.92533333333333,9.855999999999995,286,307,21,5,chroma_acts
437,8,143.92533333333333,191.411,47.485666666666674,307,407,100,5,chroma_acts
438,1,0.0,30.816,30.816,0,65,65,5,chroma_acts
438,2,30.816,60.096,29.279999999999998,65,126,61,5,chroma_acts
438,3,60.096,108.576,48.48,126,227,101,5,chroma_acts
438,4,108.576,116.736,8.16000000000001,227,244,17,5,chroma_acts
438,5,116.736,124.416,7.679999999999993,244,260,16,5,chroma_acts
438,6,124.416,137.376,12.960000000000008,260,287,27,5,chroma_acts
438,7,137.376,143.136,5.759999999999991,287,299,12,5,chroma_acts
438,8,143.136,170.894,27.75800000000001,299,355,56,5,chroma_acts
439,1,0.0,29.866666666666664,29.866666666666664,0,64,64,5,chroma_acts
439,2,29.866666666666664,60.373333333333335,30.50666666666667,64,129,65,5,chroma_acts
439,3,60.373333333333335,74.92266666666666,14.549333333333323,129,160,31,5,chroma_acts
439,4,74.92266666666666,138.75199999999998,63.829333333333324,160,296,136,5,chroma_acts
439,5,138.75199999999998,142.50666666666666,3.7546666666666795,296,304,8,5,chroma_acts
439,6,142.50666666666666,146.26133333333334,3.7546666666666795,304,312,8,5,chroma_acts
439,7,146.26133333333334,153.77066666666667,7.5093333333333305,312,328,16,5,chroma_acts
439,8,153.77066666666667,180.0533333333333,26.282666666666643,328,384,56,5,chroma_acts
439,9,180.0533333333333,212.961,32.9076666666667,384,453,69,5,chroma_acts
440,1,0.0,6.677333333333333,6.677333333333333,0,15,15,4,chroma_acts
440,2,6.677333333333333,38.12266666666667,31.445333333333334,15,82,67,4,chroma_acts
440,3,38.12266666666667,52.202666666666666,14.079999999999998,82,112,30,4,chroma_acts
440,4,52.202666666666666,83.17866666666667,30.976000000000006,112,178,66,4,chroma_acts
440,5,83.17866666666667,113.216,30.037333333333322,178,242,64,4,chroma_acts
440,6,113.216,124.48,11.26400000000001,242,266,24,4,chroma_acts
440,7,124.48,141.37599999999998,16.895999999999972,266,302,36,4,chroma_acts
440,8,141.37599999999998,171.957,30.581000000000017,302,366,64,4,chroma_acts
441,1,0.0,86.38933333333333,86.38933333333333,0,127,127,4,chroma_acts
441,2,86.38933333333333,93.216,6.826666666666668,127,137,10,4,chroma_acts
441,3,93.216,153.97333333333333,60.757333333333335,137,226,89,4,chroma_acts
441,4,153.97333333333333,162.16533333333334,8.192000000000007,226,238,12,4,chroma_acts
441,5,162.16533333333334,164.896,2.73066666666665,238,242,4,4,chroma_acts
441,6,164.896,173.088,8.192000000000007,242,254,12,4,chroma_acts
441,7,173.088,175.81866666666667,2.7306666666666786,254,258,4,4,chroma_acts
441,8,175.81866666666667,187.689,11.87033333333332,258,274,16,4,chroma_acts
445,1,0.0,16.458666666666666,16.458666666666666,0,38,38,4,chroma_acts
445,2,16.458666666666666,31.328,14.869333333333334,38,72,34,4,chroma_acts
445,3,31.328,59.31733333333334,27.989333333333338,72,136,64,4,chroma_acts
445,4,59.31733333333334,72.87466666666667,13.557333333333332,136,167,31,4,chroma_acts
445,5,72.87466666666667,112.672,39.79733333333333,167,258,91,4,chroma_acts
445,6,112.672,139.34933333333333,26.677333333333337,258,319,61,4,chroma_acts
445,7,139.34933333333333,170.4,31.05066666666667,319,390,71,4,chroma_acts
445,8,170.4,173.89866666666668,3.4986666666666792,390,398,8,4,chroma_acts
445,9,173.89866666666668,191.722,17.823333333333323,398,437,39,4,chroma_acts
447,1,0.0,14.15466666666667,14.15466666666667,0,32,32,5,chroma_acts
447,2,14.15466666666667,71.49866666666668,57.34400000000001,32,160,128,5,chroma_acts
447,3,71.49866666666668,97.48266666666667,25.983999999999995,160,218,58,5,chroma_acts
447,4,97.48266666666667,114.50666666666669,17.024000000000015,218,256,38,5,chroma_acts
447,5,114.50666666666669,140.9386666666667,26.432000000000016,256,315,59,5,chroma_acts
447,6,140.9386666666667,146.7626666666667,5.823999999999984,315,328,13,5,chroma_acts
447,7,146.7626666666667,157.5146666666667,10.75200000000001,328,352,24,5,chroma_acts
447,8,157.5146666666667,200.0746666666667,42.56,352,447,95,5,chroma_acts
447,9,200.0746666666667,209.105,9.030333333333289,447,466,19,5,chroma_acts
448,1,0.0,29.461333333333336,29.461333333333336,0,61,61,4,chroma_acts
448,2,29.461333333333336,38.29333333333334,8.832,61,79,18,4,chroma_acts
448,3,38.29333333333334,56.448,18.154666666666664,79,116,37,4,chroma_acts
448,4,56.448,73.13066666666667,16.68266666666667,116,150,34,4,chroma_acts
448,5,73.13066666666667,89.81333333333333,16.682666666666663,150,184,34,4,chroma_acts
448,6,89.81333333333333,120.72533333333334,30.912000000000006,184,247,63,4,chroma_acts
448,7,120.72533333333334,185.00266666666667,64.27733333333333,247,378,131,4,chroma_acts
448,8,185.00266666666667,232.10666666666668,47.10400000000001,378,474,96,4,chroma_acts
448,9,232.10666666666668,293.563,61.456333333333305,474,598,124,4,chroma_acts
450,1,0.0,12.672,12.672,0,26,26,5,chroma_acts
450,2,12.672,16.597333333333335,3.9253333333333345,26,34,8,5,chroma_acts
450,3,16.597333333333335,44.074666666666666,27.47733333333333,34,90,56,5,chroma_acts
450,4,44.074666666666666,87.25333333333333,43.178666666666665,90,178,88,5,chroma_acts
450,5,87.25333333333333,138.77333333333334,51.52000000000001,178,283,105,5,chroma_acts
450,6,138.77333333333334,181.95200000000003,43.178666666666686,283,371,88,5,chroma_acts
450,7,181.95200000000003,185.87733333333335,3.9253333333333273,371,379,8,5,chroma_acts
450,8,185.87733333333335,189.80266666666668,3.9253333333333273,379,387,8,5,chroma_acts
450,9,189.80266666666668,200.479,10.676333333333332,387,407,20,5,chroma_acts
451,1,0.0,7.477333333333333,7.477333333333333,0,16,16,5,chroma_acts
451,2,7.477333333333333,30.005333333333333,22.528,16,64,48,5,chroma_acts
451,3,30.005333333333333,58.16533333333333,28.159999999999997,64,124,60,5,chroma_acts
451,4,58.16533333333333,73.184,15.018666666666668,124,156,32,5,chroma_acts
451,5,73.184,76.93866666666666,3.7546666666666653,156,164,8,5,chroma_acts
451,6,76.93866666666666,78.816,1.8773333333333397,164,168,4,5,chroma_acts
451,7,78.816,80.69333333333333,1.8773333333333255,168,172,4,5,chroma_acts
451,8,80.69333333333333,112.13866666666667,31.445333333333338,172,239,67,5,chroma_acts
451,9,112.13866666666667,165.0,52.861333333333334,239,350,111,5,chroma_acts
452,1,0.0,10.698666666666666,10.698666666666666,0,23,23,5,chroma_acts
452,2,10.698666666666666,14.453333333333333,3.754666666666667,23,31,8,5,chroma_acts
452,3,14.453333333333333,26.186666666666667,11.733333333333334,31,56,25,5,chroma_acts
452,4,26.186666666666667,29.472,3.285333333333334,56,63,7,5,chroma_acts
452,5,29.472,41.20533333333333,11.733333333333327,63,88,25,5,chroma_acts
452,6,41.20533333333333,78.752,37.54666666666667,88,168,80,5,chroma_acts
452,7,78.752,123.80799999999999,45.056,168,264,96,5,chroma_acts
452,8,123.80799999999999,154.31466666666668,30.50666666666669,264,329,65,5,chroma_acts
452,9,154.31466666666668,187.781,33.466333333333324,329,399,70,5,chroma_acts
453,1,0.0,14.911999999999999,14.911999999999999,0,32,32,4,chroma_acts
453,2,14.911999999999999,30.272,15.36,32,64,32,4,chroma_acts
453,3,30.272,37.952,7.68,64,80,16,4,chroma_acts
453,4,37.952,45.632,7.68,80,96,16,4,chroma_acts
453,5,45.632,94.112,48.48,96,197,101,4,chroma_acts
453,6,94.112,105.63199999999999,11.519999999999996,197,221,24,4,chroma_acts
453,7,105.63199999999999,114.27199999999999,8.64,221,239,18,4,chroma_acts
453,8,114.27199999999999,121.952,7.680000000000007,239,255,16,4,chroma_acts
453,9,121.952,169.782,47.83000000000001,255,353,98,4,chroma_acts
454,1,0.0,11.306666666666667,11.306666666666667,0,25,25,4,chroma_acts
454,2,11.306666666666667,15.061333333333334,3.754666666666667,25,33,8,4,chroma_acts
454,3,15.061333333333334,45.568,30.506666666666664,33,98,65,4,chroma_acts
454,4,45.568,75.60533333333333,30.037333333333336,98,162,64,4,chroma_acts
454,5,75.60533333333333,90.624,15.018666666666661,162,194,32,4,chroma_acts
454,6,90.624,135.68,45.05600000000001,194,290,96,4,chroma_acts
454,7,135.68,166.656,30.976,290,356,66,4,chroma_acts
454,8,166.656,213.383,46.727000000000004,356,454,98,4,chroma_acts
456,1,0.0,33.632,33.632,0,72,72,3,chroma_acts
456,2,33.632,59.91466666666667,26.28266666666667,72,128,56,3,chroma_acts
456,3,59.91466666666667,63.669333333333334,3.7546666666666653,128,136,8,3,chroma_acts
456,4,63.669333333333334,78.68799999999999,15.018666666666654,136,168,32,3,chroma_acts
456,5,78.68799999999999,119.98933333333332,41.30133333333333,168,256,88,3,chroma_acts
456,6,119.98933333333332,135.47733333333335,15.488000000000028,256,289,33,3,chroma_acts
456,7,135.47733333333335,138.76266666666666,3.2853333333333126,289,296,7,3,chroma_acts
456,8,138.76266666666666,170.17,31.407333333333327,296,361,65,3,chroma_acts
457,1,0.0,3.3173333333333335,3.3173333333333335,0,8,8,5,chroma_acts
457,2,3.3173333333333335,6.645333333333333,3.328,8,16,8,5,chroma_acts
457,3,6.645333333333333,27.029333333333337,20.384000000000004,16,65,49,5,chroma_acts
457,4,27.029333333333337,52.40533333333334,25.376,65,126,61,5,chroma_acts
457,5,52.40533333333334,79.86133333333333,27.455999999999996,126,192,66,5,chroma_acts
457,6,79.86133333333333,92.34133333333335,12.480000000000018,192,222,30,5,chroma_acts
457,7,92.34133333333335,118.13333333333335,25.792,222,284,62,5,chroma_acts
457,8,118.13333333333335,145.17333333333335,27.039999999999992,284,349,65,5,chroma_acts
457,9,145.17333333333335,200.244,55.070666666666654,349,480,131,5,chroma_acts
458,1,0.0,21.866666666666667,21.866666666666667,0,32,32,4,chroma_acts
458,2,21.866666666666667,62.69866666666667,40.832,32,90,58,4,chroma_acts
458,3,62.69866666666667,64.10666666666667,1.4080000000000013,90,92,2,4,chroma_acts
458,4,64.10666666666667,67.62666666666667,3.519999999999996,92,97,5,4,chroma_acts
458,5,67.62666666666667,86.63466666666666,19.007999999999996,97,124,27,4,chroma_acts
458,6,86.63466666666666,90.85866666666666,4.224000000000004,124,130,6,4,chroma_acts
458,7,90.85866666666666,92.26666666666665,1.407999999999987,130,132,2,4,chroma_acts
458,8,92.26666666666665,101.41866666666665,9.152000000000001,132,145,13,4,chroma_acts
458,9,101.41866666666665,113.051,11.63233333333335,145,160,15,4,chroma_acts
459,1,0.0,55.21066666666667,55.21066666666667,0,130,130,4,chroma_acts
459,2,55.21066666666667,78.25066666666666,23.039999999999992,130,184,54,4,chroma_acts
459,3,78.25066666666666,81.664,3.413333333333341,184,192,8,4,chroma_acts
459,4,81.664,110.67733333333334,29.013333333333335,192,260,68,4,chroma_acts
459,5,110.67733333333334,124.75733333333334,14.079999999999998,260,293,33,4,chroma_acts
459,6,124.75733333333334,137.13066666666668,12.373333333333349,293,322,29,4,chroma_acts
459,7,137.13066666666668,149.9306666666667,12.800000000000011,322,352,30,4,chroma_acts
459,8,149.9306666666667,193.024,43.093333333333305,352,453,101,4,chroma_acts
459,9,193.024,220.167,27.143,453,515,62,4,chroma_acts
460,1,0.0,22.410666666666668,22.410666666666668,0,59,59,4,chroma_acts
460,2,22.410666666666668,47.75466666666667,25.344000000000005,59,125,66,4,chroma_acts
460,3,47.75466666666667,73.09866666666667,25.344,125,191,66,4,chroma_acts
460,4,73.09866666666667,95.75466666666667,22.65599999999999,191,250,59,4,chroma_acts
460,5,95.75466666666667,121.48266666666666,25.727999999999994,250,317,67,4,chroma_acts
460,6,121.48266666666666,144.90666666666667,23.424000000000007,317,378,61,4,chroma_acts
460,7,144.90666666666667,149.89866666666666,4.99199999999999,378,391,13,4,chroma_acts
460,8,149.89866666666666,175.24266666666668,25.344000000000023,391,457,66,4,chroma_acts
460,9,175.24266666666668,198.077,22.83433333333332,457,515,58,4,chroma_acts
461,1,0.0,22.432000000000002,22.432000000000002,0,41,41,4,chroma_acts
461,2,22.432000000000002,26.314666666666668,3.8826666666666654,41,48,7,4,chroma_acts
461,3,26.314666666666668,31.306666666666665,4.991999999999997,48,57,9,4,chroma_acts
461,4,31.306666666666665,44.61866666666667,13.312000000000005,57,81,24,4,chroma_acts
461,5,44.61866666666667,54.602666666666664,9.983999999999995,81,99,18,4,chroma_acts
461,6,54.602666666666664,90.10133333333334,35.49866666666668,99,163,64,4,chroma_acts
461,7,90.10133333333334,116.72533333333334,26.623999999999995,163,211,48,4,chroma_acts
461,8,116.72533333333334,126.70933333333332,9.98399999999998,211,229,18,4,chroma_acts
461,9,126.70933333333332,199.805,73.09566666666669,229,359,130,4,chroma_acts
462,1,0.0,36.330666666666666,36.330666666666666,0,80,80,5,chroma_acts
462,2,36.330666666666666,43.66933333333333,7.338666666666661,80,96,16,5,chroma_acts
462,3,43.66933333333333,89.07733333333333,45.408,96,195,99,5,chroma_acts
462,4,89.07733333333333,119.34933333333332,30.27199999999999,195,261,66,5,chroma_acts
462,5,119.34933333333332,145.4933333333333,26.14399999999999,261,318,57,5,chroma_acts
462,6,145.4933333333333,169.80266666666665,24.309333333333342,318,371,53,5,chroma_acts
462,7,169.80266666666665,177.1413333333333,7.338666666666654,371,387,16,5,chroma_acts
462,8,177.1413333333333,206.95466666666664,29.813333333333333,387,452,65,5,chroma_acts
462,9,206.95466666666664,220.699,13.744333333333373,452,480,28,5,chroma_acts
463,1,0.0,39.63733333333334,39.63733333333334,0,58,58,4,chroma_acts
463,2,39.63733333333334,45.87733333333334,6.240000000000002,58,67,9,4,chroma_acts
463,3,45.87733333333334,70.144,24.266666666666666,67,102,35,4,chroma_acts
463,4,70.144,99.95733333333334,29.813333333333333,102,145,43,4,chroma_acts
463,5,99.95733333333334,110.35733333333334,10.400000000000006,145,160,15,4,chroma_acts
463,6,110.35733333333334,132.544,22.186666666666667,160,192,32,4,chroma_acts
463,7,132.544,157.50400000000002,24.960000000000008,192,228,36,4,chroma_acts
463,8,157.50400000000002,174.588,17.083999999999975,228,251,23,4,chroma_acts
464,1,0.0,28.597333333333335,28.597333333333335,0,61,61,4,chroma_acts
464,2,28.597333333333335,38.922666666666665,10.32533333333333,61,83,22,4,chroma_acts
464,3,38.922666666666665,74.12266666666666,35.199999999999996,83,158,75,4,chroma_acts
464,4,74.12266666666666,121.99466666666666,47.872,158,260,102,4,chroma_acts
464,5,121.99466666666666,136.07466666666667,14.080000000000013,260,290,30,4,chroma_acts
464,6,136.07466666666667,168.928,32.853333333333325,290,360,70,4,chroma_acts
464,7,168.928,181.6,12.671999999999997,360,387,27,4,chroma_acts
464,8,181.6,200.55,18.950000000000017,387,426,39,4,chroma_acts
465,1,0.0,45.70666666666667,45.70666666666667,0,96,96,4,chroma_acts
465,2,45.70666666666667,106.66666666666667,60.96,96,223,127,4,chroma_acts
465,3,106.66666666666667,136.90666666666664,30.239999999999966,223,286,63,4,chroma_acts
465,4,136.90666666666664,167.62666666666664,30.72,286,350,64,4,chroma_acts
465,5,167.62666666666664,182.98666666666665,15.360000000000014,350,382,32,4,chroma_acts
465,6,182.98666666666665,188.74666666666664,5.759999999999991,382,394,12,4,chroma_acts
465,7,188.74666666666664,191.14666666666665,2.4000000000000057,394,399,5,4,chroma_acts
465,8,191.14666666666665,196.42666666666665,5.280000000000001,399,410,11,4,chroma_acts
465,9,196.42666666666665,213.393,16.966333333333353,410,444,34,4,chroma_acts
466,1,0.0,15.189333333333334,15.189333333333334,0,32,32,4,chroma_acts
466,2,15.189333333333334,64.62933333333334,49.44,32,135,103,4,chroma_acts
466,3,64.62933333333334,91.02933333333333,26.39999999999999,135,190,55,4,chroma_acts
466,4,91.02933333333333,94.86933333333333,3.8400000000000034,190,198,8,4,chroma_acts
466,5,94.86933333333333,136.62933333333334,41.760000000000005,198,285,87,4,chroma_acts
466,6,136.62933333333334,140.46933333333334,3.8400000000000034,285,293,8,4,chroma_acts
466,7,140.46933333333334,144.78933333333333,4.319999999999993,293,302,9,4,chroma_acts
466,8,144.78933333333333,152.376,7.586666666666673,302,316,14,4,chroma_acts
467,1,0.0,15.125333333333334,15.125333333333334,0,33,33,4,chroma_acts
467,2,15.125333333333334,30.144,15.018666666666665,33,65,32,4,chroma_acts
467,3,30.144,59.711999999999996,29.567999999999998,65,128,63,4,chroma_acts
467,4,59.711999999999996,118.848,59.136,128,254,126,4,chroma_acts
467,5,118.848,119.78666666666666,0.9386666666666628,254,256,2,4,chroma_acts
467,6,119.78666666666666,134.33599999999998,14.549333333333323,256,287,31,4,chroma_acts
467,7,134.33599999999998,149.82399999999998,15.488,287,320,33,4,chroma_acts
467,8,149.82399999999998,209.89866666666666,60.07466666666667,320,448,128,4,chroma_acts
467,9,209.89866666666666,240.305,30.40633333333335,448,511,63,4,chroma_acts
468,1,0.0,30.752,30.752,0,65,65,2,chroma_acts
468,2,30.752,75.392,44.64,65,158,93,2,chroma_acts
468,3,75.392,77.312,1.9200000000000017,158,162,4,2,chroma_acts
468,4,77.312,92.192,14.879999999999995,162,193,31,2,chroma_acts
468,5,92.192,99.872,7.680000000000007,193,209,16,2,chroma_acts
468,6,99.872,120.032,20.159999999999997,209,251,42,2,chroma_acts
468,7,120.032,131.072,11.040000000000006,251,274,23,2,chroma_acts
468,8,131.072,192.693,61.62100000000001,274,401,127,2,chroma_acts
470,1,0.0,14.911999999999999,14.911999999999999,0,32,32,5,chroma_acts
470,2,14.911999999999999,29.311999999999998,14.399999999999999,32,62,30,5,chroma_acts
470,3,29.311999999999998,44.672,15.36,62,94,32,5,chroma_acts
470,4,44.672,105.152,60.480000000000004,94,220,126,5,chroma_acts
470,5,105.152,125.792,20.64,220,263,43,5,chroma_acts
470,6,125.792,128.672,2.8799999999999955,263,269,6,5,chroma_acts
470,7,128.672,136.352,7.680000000000007,269,285,16,5,chroma_acts
470,8,136.352,152.192,15.840000000000003,285,318,33,5,chroma_acts
470,9,152.192,212.851,60.65899999999999,318,443,125,5,chroma_acts
472,1,0.0,54.272,54.272,0,114,114,4,chroma_acts
472,2,54.272,94.592,40.32,114,198,84,4,chroma_acts
472,3,94.592,123.392,28.799999999999997,198,258,60,4,chroma_acts
472,4,123.392,139.232,15.840000000000003,258,291,33,4,chroma_acts
472,5,139.232,161.792,22.560000000000002,291,338,47,4,chroma_acts
472,6,161.792,224.672,62.879999999999995,338,469,131,4,chroma_acts
472,7,224.672,240.03199999999998,15.359999999999985,469,501,32,4,chroma_acts
472,8,240.03199999999998,265.581,25.549000000000035,501,553,52,4,chroma_acts
474,1,0.0,30.282666666666664,30.282666666666664,0,64,64,4,chroma_acts
474,2,30.282666666666664,61.00266666666667,30.720000000000006,64,128,64,4,chroma_acts
474,3,61.00266666666667,75.88266666666667,14.879999999999995,128,159,31,4,chroma_acts
474,4,75.88266666666667,106.60266666666666,30.72,159,223,64,4,chroma_acts
474,5,106.60266666666666,152.20266666666666,45.599999999999994,223,318,95,4,chroma_acts
474,6,152.20266666666666,215.08266666666665,62.879999999999995,318,449,131,4,chroma_acts
474,7,215.08266666666665,220.84266666666667,5.760000000000019,449,461,12,4,chroma_acts
474,8,220.84266666666667,227.221,6.37833333333333,461,473,12,4,chroma_acts
476,1,0.0,22.08,22.08,0,49,49,4,chroma_acts
476,2,22.08,29.418666666666663,7.338666666666665,49,65,16,4,chroma_acts
476,3,29.418666666666663,58.773333333333326,29.354666666666663,65,129,64,4,chroma_acts
476,4,58.773333333333326,73.45066666666666,14.677333333333337,129,161,32,4,chroma_acts
476,5,73.45066666666666,102.80533333333332,29.35466666666666,161,225,64,4,chroma_acts
476,6,102.80533333333332,145.00266666666664,42.19733333333332,225,317,92,4,chroma_acts
476,7,145.00266666666664,146.8373333333333,1.8346666666666636,317,321,4,4,chroma_acts
476,8,146.8373333333333,222.05866666666662,75.22133333333332,321,485,164,4,chroma_acts
476,9,222.05866666666662,268.609,46.550333333333356,485,585,100,4,chroma_acts
478,1,0.0,64.43733333333333,64.43733333333333,0,126,126,5,chroma_acts
478,2,64.43733333333333,81.84533333333333,17.408,126,160,34,5,chroma_acts
478,3,81.84533333333333,96.18133333333333,14.335999999999999,160,188,28,5,chroma_acts
478,4,96.18133333333333,100.27733333333333,4.096000000000004,188,196,8,5,chroma_acts
478,5,100.27733333333333,111.02933333333333,10.751999999999995,196,217,21,5,chroma_acts
478,6,111.02933333333333,128.94933333333333,17.92,217,252,35,5,chroma_acts
478,7,128.94933333333333,163.76533333333333,34.816,252,320,68,5,chroma_acts
478,8,163.76533333333333,180.805,17.039666666666676,320,352,32,5,chroma_acts
479,1,0.0,11.488,11.488,0,25,25,5,chroma_acts
479,2,11.488,15.242666666666667,3.754666666666667,25,33,8,5,chroma_acts
479,3,15.242666666666667,61.23733333333333,45.99466666666667,33,131,98,5,chroma_acts
479,4,61.23733333333333,107.232,45.99466666666667,131,229,98,5,chroma_acts
479,5,107.232,120.37333333333333,13.141333333333336,229,257,28,5,chroma_acts
479,6,120.37333333333333,170.59199999999998,50.21866666666665,257,364,107,5,chroma_acts
479,7,170.59199999999998,212.36266666666666,41.77066666666667,364,453,89,5,chroma_acts
479,8,212.36266666666666,240.52266666666665,28.159999999999997,453,513,60,5,chroma_acts
479,9,240.52266666666665,251.706,11.183333333333337,513,535,22,5,chroma_acts
480,1,0.0,46.592,46.592,0,98,98,4,chroma_acts
480,2,46.592,92.672,46.08,98,194,96,4,chroma_acts
480,3,92.672,122.432,29.760000000000005,194,256,62,4,chroma_acts
480,4,122.432,127.71199999999999,5.279999999999987,256,267,11,4,chroma_acts
480,5,127.71199999999999,154.112,26.400000000000006,267,322,55,4,chroma_acts
480,6,154.112,216.512,62.400000000000006,322,452,130,4,chroma_acts
480,7,216.512,246.272,29.75999999999999,452,514,62,4,chroma_acts
480,8,246.272,251.552,5.280000000000001,514,525,11,4,chroma_acts
480,9,251.552,325.08,73.52799999999999,525,677,152,4,chroma_acts
481,1,0.0,42.261333333333326,42.261333333333326,0,89,89,4,chroma_acts
481,2,42.261333333333326,62.901333333333326,20.64,89,132,43,4,chroma_acts
481,3,62.901333333333326,76.82133333333333,13.920000000000002,132,161,29,4,chroma_acts
481,4,76.82133333333333,92.18133333333333,15.36,161,193,32,4,chroma_acts
481,5,92.18133333333333,140.18133333333333,48.0,193,293,100,4,chroma_acts
481,6,140.18133333333333,168.9813333333333,28.799999999999983,293,353,60,4,chroma_acts
481,7,168.9813333333333,182.90133333333333,13.920000000000016,353,382,29,4,chroma_acts
481,8,182.90133333333333,259.70133333333337,76.80000000000004,382,542,160,4,chroma_acts
481,9,259.70133333333337,275.358,15.656666666666638,542,573,31,4,chroma_acts
487,1,0.0,46.687999999999995,46.687999999999995,0,126,126,3,chroma_acts
487,2,46.687999999999995,81.40799999999999,34.71999999999999,126,219,93,3,chroma_acts
487,3,81.40799999999999,93.35466666666666,11.946666666666673,219,251,32,3,chroma_acts
487,4,93.35466666666666,113.51466666666666,20.159999999999997,251,305,54,3,chroma_acts
487,5,113.51466666666666,140.02133333333333,26.506666666666675,305,376,71,3,chroma_acts
487,6,140.02133333333333,151.59466666666665,11.573333333333323,376,407,31,3,chroma_acts
487,7,151.59466666666665,196.76799999999997,45.17333333333332,407,528,121,3,chroma_acts
487,8,196.76799999999997,226.442,29.674000000000035,528,606,78,3,chroma_acts
489,1,0.0,104.37333333333333,104.37333333333333,0,147,147,3,chroma_acts
489,2,104.37333333333333,107.94666666666667,3.5733333333333377,147,152,5,3,chroma_acts
489,3,107.94666666666667,112.23466666666667,4.287999999999997,152,158,6,3,chroma_acts
489,4,112.23466666666667,115.808,3.5733333333333377,158,163,5,3,chroma_acts
489,5,115.808,119.38133333333333,3.5733333333333235,163,168,5,3,chroma_acts
489,6,119.38133333333333,123.66933333333334,4.288000000000011,168,174,6,3,chroma_acts
489,7,123.66933333333334,127.24266666666666,3.5733333333333235,174,179,5,3,chroma_acts
489,8,127.24266666666666,130.816,3.5733333333333377,179,184,5,3,chroma_acts
489,9,130.816,170.197,39.381,184,238,54,3,chroma_acts
490,1,0.0,13.418666666666667,13.418666666666667,0,29,29,5,chroma_acts
490,2,13.418666666666667,30.314666666666668,16.896,29,65,36,5,chroma_acts
490,3,30.314666666666668,75.84,45.525333333333336,65,162,97,5,chroma_acts
490,4,75.84,106.34666666666666,30.50666666666666,162,227,65,5,chroma_acts
490,5,106.34666666666666,122.304,15.957333333333338,227,261,34,5,chroma_acts
490,6,122.304,134.50666666666666,12.202666666666659,261,287,26,5,chroma_acts
490,7,134.50666666666666,170.176,35.66933333333333,287,363,76,5,chroma_acts
490,8,170.176,183.31733333333332,13.141333333333336,363,391,28,5,chroma_acts
490,9,183.31733333333332,201.443,18.12566666666669,391,428,37,5,chroma_acts
491,1,0.0,19.274666666666665,19.274666666666665,0,41,41,4,chroma_acts
491,2,19.274666666666665,53.35466666666667,34.08,41,112,71,4,chroma_acts
491,3,53.35466666666667,63.434666666666665,10.079999999999998,112,133,21,4,chroma_acts
491,4,63.434666666666665,90.31466666666665,26.87999999999999,133,189,56,4,chroma_acts
491,5,90.31466666666665,92.71466666666666,2.4000000000000057,189,194,5,4,chroma_acts
491,6,92.71466666666666,121.99466666666666,29.28,194,255,61,4,chroma_acts
491,7,121.99466666666666,170.95466666666667,48.96000000000001,255,357,102,4,chroma_acts
491,8,170.95466666666667,200.64,29.68533333333332,357,417,60,4,chroma_acts
493,1,0.0,7.968,7.968,0,17,17,4,chroma_acts
493,2,7.968,22.848,14.879999999999999,17,48,31,4,chroma_acts
493,3,22.848,54.047999999999995,31.199999999999996,48,113,65,4,chroma_acts
493,4,54.047999999999995,85.24799999999999,31.199999999999996,113,178,65,4,chroma_acts
493,5,85.24799999999999,105.88799999999999,20.64,178,221,43,4,chroma_acts
493,6,105.88799999999999,121.24799999999999,15.36,221,253,32,4,chroma_acts
493,7,121.24799999999999,122.68799999999999,1.4399999999999977,253,256,3,4,chroma_acts
493,8,122.68799999999999,138.725,16.037000000000006,256,288,32,4,chroma_acts
494,1,0.0,29.205333333333332,29.205333333333332,0,63,63,4,chroma_acts
494,2,29.205333333333332,52.672000000000004,23.466666666666672,63,113,50,4,chroma_acts
494,3,52.672000000000004,69.568,16.895999999999994,113,149,36,4,chroma_acts
494,4,69.568,105.23733333333334,35.66933333333334,149,225,76,4,chroma_acts
494,5,105.23733333333334,187.83999999999997,82.60266666666664,225,401,176,4,chroma_acts
494,6,187.83999999999997,223.04,35.20000000000002,401,476,75,4,chroma_acts
494,7,223.04,292.5013333333333,69.46133333333333,476,624,148,4,chroma_acts
494,8,292.5013333333333,322.06933333333336,29.56800000000004,624,687,63,4,chroma_acts
494,9,322.06933333333336,357.226,35.15666666666664,687,760,73,4,chroma_acts
498,1,0.0,14.933333333333332,14.933333333333332,0,32,32,5,chroma_acts
498,2,14.933333333333332,44.21333333333333,29.28,32,93,61,5,chroma_acts
498,3,44.21333333333333,74.93333333333332,30.71999999999999,93,157,64,5,chroma_acts
498,4,74.93333333333332,97.49333333333333,22.560000000000002,157,204,47,5,chroma_acts
498,5,97.49333333333333,102.77333333333333,5.280000000000001,204,215,11,5,chroma_acts
498,6,102.77333333333333,105.17333333333333,2.4000000000000057,215,220,5,5,chroma_acts
498,7,105.17333333333333,133.01333333333332,27.83999999999999,220,278,58,5,chroma_acts
498,8,133.01333333333332,135.41333333333333,2.4000000000000057,278,283,5,5,chroma_acts
498,9,135.41333333333333,183.724,48.31066666666666,283,382,99,5,chroma_acts
499,1,0.0,30.410666666666664,30.410666666666664,0,64,64,4,chroma_acts
499,2,30.410666666666664,63.53066666666667,33.120000000000005,64,133,69,4,chroma_acts
499,3,63.53066666666667,87.53066666666666,23.999999999999993,133,183,50,4,chroma_acts
499,4,87.53066666666666,91.37066666666666,3.8400000000000034,183,191,8,4,chroma_acts
499,5,91.37066666666666,96.17066666666666,4.799999999999997,191,201,10,4,chroma_acts
499,6,96.17066666666666,133.13066666666668,36.96000000000002,201,278,77,4,chroma_acts
499,7,133.13066666666668,168.538,35.40733333333333,278,350,72,4,chroma_acts
501,1,0.0,24.981333333333332,24.981333333333332,0,54,54,5,chroma_acts
501,2,24.981333333333332,30.144,5.1626666666666665,54,65,11,5,chroma_acts
501,3,30.144,75.66933333333334,45.52533333333334,65,162,97,5,chroma_acts
501,4,75.66933333333334,88.34133333333334,12.671999999999997,162,189,27,5,chroma_acts
501,5,88.34133333333334,92.096,3.7546666666666653,189,197,8,5,chroma_acts
501,6,92.096,93.97333333333333,1.8773333333333255,197,201,4,5,chroma_acts
501,7,93.97333333333333,95.85066666666667,1.8773333333333397,201,205,4,5,chroma_acts
501,8,95.85066666666667,105.23733333333334,9.38666666666667,205,225,20,5,chroma_acts
501,9,105.23733333333334,165.219,59.981666666666655,225,351,126,5,chroma_acts
502,1,0.0,7.477333333333334,7.477333333333334,0,11,11,3,chroma_acts
502,2,7.477333333333334,60.17066666666666,52.69333333333333,11,87,76,3,chroma_acts
502,3,60.17066666666666,89.984,29.813333333333333,87,130,43,3,chroma_acts
502,4,89.984,112.17066666666666,22.186666666666667,130,162,32,3,chroma_acts
502,5,112.17066666666666,119.79733333333333,7.626666666666665,162,173,11,3,chroma_acts
502,6,119.79733333333333,146.144,26.34666666666668,173,211,38,3,chroma_acts
502,7,146.144,164.864,18.72,211,238,27,3,chroma_acts
502,8,164.864,180.0,15.135999999999996,238,258,20,3,chroma_acts
504,1,0.0,21.024,21.024,0,44,44,4,chroma_acts
504,2,21.024,24.864,3.84,44,52,8,4,chroma_acts
504,3,24.864,53.184,28.319999999999997,52,111,59,4,chroma_acts
504,4,53.184,69.504,16.320000000000007,111,145,34,4,chroma_acts
504,5,69.504,101.184,31.679999999999993,145,211,66,4,chroma_acts
504,6,101.184,131.904,30.72,211,275,64,4,chroma_acts
504,7,131.904,146.784,14.879999999999995,275,306,31,4,chroma_acts
504,8,146.784,193.753,46.968999999999994,306,402,96,4,chroma_acts
507,1,0.0,27.349333333333337,27.349333333333337,0,65,65,5,chroma_acts
507,2,27.349333333333337,42.70933333333333,15.359999999999996,65,101,36,5,chroma_acts
507,3,42.70933333333333,47.40266666666667,4.693333333333335,101,112,11,5,chroma_acts
507,4,47.40266666666667,49.96266666666667,2.5600000000000023,112,118,6,5,chroma_acts
507,5,49.96266666666667,67.456,17.493333333333332,118,159,41,5,chroma_acts
507,6,67.456,97.32266666666668,29.866666666666674,159,229,70,5,chroma_acts
507,7,97.32266666666668,129.74933333333334,32.42666666666666,229,305,76,5,chroma_acts
507,8,129.74933333333334,206.54933333333335,76.80000000000001,305,485,180,5,chroma_acts
507,9,206.54933333333335,222.194,15.644666666666637,485,520,35,5,chroma_acts
508,1,0.0,7.775999999999999,7.775999999999999,0,19,19,4,chroma_acts
508,2,7.775999999999999,11.616,3.8400000000000007,19,28,9,4,chroma_acts
508,3,11.616,21.429333333333332,9.813333333333333,28,51,23,4,chroma_acts
508,4,21.429333333333332,25.269333333333336,3.8400000000000034,51,60,9,4,chroma_acts
508,5,25.269333333333336,35.08266666666667,9.813333333333333,60,83,23,4,chroma_acts
508,6,35.08266666666667,39.349333333333334,4.266666666666666,83,93,10,4,chroma_acts
508,7,39.349333333333334,107.61600000000001,68.26666666666668,93,253,160,4,chroma_acts
508,8,107.61600000000001,137.056,29.439999999999998,253,322,69,4,chroma_acts
508,9,137.056,191.822,54.76599999999999,322,449,127,4,chroma_acts
509,1,0.0,25.013333333333332,25.013333333333332,0,59,59,4,chroma_acts
509,2,25.013333333333332,53.6,28.58666666666667,59,126,67,4,chroma_acts
509,3,53.6,67.68,14.080000000000005,126,159,33,4,chroma_acts
509,4,67.68,79.62666666666667,11.946666666666658,159,187,28,4,chroma_acts
509,5,79.62666666666667,101.38666666666667,21.760000000000005,187,238,51,4,chroma_acts
509,6,101.38666666666667,134.24,32.85333333333334,238,315,77,4,chroma_acts
509,7,134.24,141.92000000000002,7.680000000000007,315,333,18,4,chroma_acts
509,8,141.92000000000002,202.5066666666667,60.58666666666667,333,475,142,4,chroma_acts
509,9,202.5066666666667,217.0,14.493333333333311,475,507,32,4,chroma_acts
510,1,0.0,4.6080000000000005,4.6080000000000005,0,10,10,3,chroma_acts
510,2,4.6080000000000005,6.485333333333333,1.8773333333333326,10,14,4,3,chroma_acts
510,3,6.485333333333333,8.362666666666666,1.8773333333333326,14,18,4,3,chroma_acts
510,4,8.362666666666666,10.24,1.8773333333333344,18,22,4,3,chroma_acts
510,5,10.24,29.013333333333332,18.773333333333333,22,62,40,3,chroma_acts
510,6,29.013333333333332,76.416,47.40266666666666,62,163,101,3,chroma_acts
510,7,76.416,126.63466666666666,50.218666666666664,163,270,107,3,chroma_acts
510,8,126.63466666666666,174.866,48.23133333333335,270,371,101,3,chroma_acts
511,1,0.0,16.746666666666666,16.746666666666666,0,36,36,5,chroma_acts
511,2,16.746666666666666,30.357333333333333,13.610666666666667,36,65,29,5,chroma_acts
511,3,30.357333333333333,42.090666666666664,11.73333333333333,65,90,25,5,chroma_acts
511,4,42.090666666666664,90.43199999999999,48.341333333333324,90,193,103,5,chroma_acts
511,5,90.43199999999999,118.12266666666666,27.690666666666672,193,252,59,5,chroma_acts
511,6,118.12266666666666,129.38666666666666,11.263999999999996,252,276,24,5,chroma_acts
511,7,129.38666666666666,133.14133333333334,3.7546666666666795,276,284,8,5,chroma_acts
511,8,133.14133333333334,149.09866666666665,15.95733333333331,284,318,34,5,chroma_acts
511,9,149.09866666666665,196.939,47.84033333333335,318,418,100,5,chroma_acts
512,1,0.0,6.122666666666667,6.122666666666667,0,16,16,4,chroma_acts
512,2,6.122666666666667,45.03466666666667,38.912000000000006,16,112,96,4,chroma_acts
512,3,45.03466666666667,51.52,6.48533333333333,112,128,16,4,chroma_acts
512,4,51.52,57.6,6.079999999999998,128,143,15,4,chroma_acts
512,5,57.6,108.26666666666668,50.66666666666668,143,268,125,4,chroma_acts
512,6,108.26666666666668,128.53333333333336,20.26666666666668,268,318,50,4,chroma_acts
512,7,128.53333333333336,134.208,5.6746666666666385,318,332,14,4,chroma_acts
512,8,134.208,160.14933333333335,25.941333333333347,332,396,64,4,chroma_acts
512,9,160.14933333333335,211.2,51.05066666666664,396,520,124,4,chroma_acts
514,1,0.0,26.912,26.912,0,57,57,5,chroma_acts
514,2,26.912,74.91199999999999,47.99999999999999,57,157,100,5,chroma_acts
514,3,74.91199999999999,80.192,5.280000000000001,157,168,11,5,chroma_acts
514,4,80.192,123.872,43.68000000000001,168,259,91,5,chroma_acts
514,5,123.872,132.03199999999998,8.159999999999982,259,276,17,5,chroma_acts
514,6,132.03199999999998,168.992,36.96000000000001,276,353,77,5,chroma_acts
514,7,168.992,197.31199999999998,28.319999999999993,353,412,59,5,chroma_acts
514,8,197.31199999999998,210.75199999999998,13.439999999999998,412,440,28,5,chroma_acts
514,9,210.75199999999998,257.991,47.239000000000004,440,537,97,5,chroma_acts
517,1,0.0,5.215999999999999,5.215999999999999,0,11,11,4,chroma_acts
517,2,5.215999999999999,10.229333333333333,5.013333333333334,11,21,10,4,chroma_acts
517,3,10.229333333333333,13.237333333333334,3.008000000000001,21,27,6,4,chroma_acts
517,4,13.237333333333334,50.336,37.09866666666667,27,101,74,4,chroma_acts
517,5,50.336,101.472,51.135999999999996,101,203,102,4,chroma_acts
517,6,101.472,145.58933333333331,44.11733333333332,203,291,88,4,chroma_acts
517,7,145.58933333333331,189.2053333333333,43.615999999999985,291,378,87,4,chroma_acts
517,8,189.2053333333333,262.68,73.4746666666667,378,523,145,4,chroma_acts
520,1,0.0,13.098666666666666,13.098666666666666,0,28,28,5,chroma_acts
520,2,13.098666666666666,45.013333333333335,31.91466666666667,28,96,68,5,chroma_acts
520,3,45.013333333333335,54.4,9.386666666666663,96,116,20,5,chroma_acts
520,4,54.4,59.562666666666665,5.1626666666666665,116,127,11,5,chroma_acts
520,5,59.562666666666665,117.76,58.19733333333334,127,251,124,5,chroma_acts
520,6,117.76,119.16799999999999,1.407999999999987,251,254,3,5,chroma_acts
520,7,119.16799999999999,145.92,26.751999999999995,254,311,57,5,chroma_acts
520,8,145.92,166.57066666666665,20.650666666666666,311,355,44,5,chroma_acts
520,9,166.57066666666665,198.75,32.179333333333346,355,422,67,5,chroma_acts
522,1,0.0,11.306666666666667,11.306666666666667,0,24,24,2,chroma_acts
522,2,11.306666666666667,29.546666666666663,18.239999999999995,24,62,38,2,chroma_acts
522,3,29.546666666666663,30.506666666666664,0.9600000000000009,62,64,2,2,chroma_acts
522,4,30.506666666666664,76.58666666666666,46.08,64,160,96,2,chroma_acts
522,5,76.58666666666666,91.46666666666667,14.88000000000001,160,191,31,2,chroma_acts
522,6,91.46666666666667,105.86666666666666,14.399999999999991,191,221,30,2,chroma_acts
522,7,105.86666666666666,125.54666666666667,19.680000000000007,221,262,41,2,chroma_acts
522,8,125.54666666666667,187.143,61.596333333333334,262,389,127,2,chroma_acts
523,1,0.0,16.757333333333335,16.757333333333335,0,36,36,4,chroma_acts
523,2,16.757333333333335,47.263999999999996,30.50666666666666,36,101,65,4,chroma_acts
523,3,47.263999999999996,66.03733333333334,18.77333333333334,101,141,40,4,chroma_acts
523,4,66.03733333333334,77.30133333333333,11.263999999999996,141,165,24,4,chroma_acts
523,5,77.30133333333333,122.82666666666667,45.525333333333336,165,262,97,4,chroma_acts
523,6,122.82666666666667,162.25066666666666,39.42399999999999,262,346,84,4,chroma_acts
523,7,162.25066666666666,164.59733333333332,2.346666666666664,346,351,5,4,chroma_acts
523,8,164.59733333333332,167.88266666666667,3.285333333333341,351,358,7,4,chroma_acts
523,9,167.88266666666667,213.56,45.67733333333334,358,454,96,4,chroma_acts
524,1,0.0,46.592,46.592,0,98,98,4,chroma_acts
524,2,46.592,60.032,13.439999999999998,98,126,28,4,chroma_acts
524,3,60.032,85.472,25.439999999999998,126,179,53,4,chroma_acts
524,4,85.472,93.152,7.680000000000007,179,195,16,4,chroma_acts
524,5,93.152,115.71199999999999,22.559999999999988,195,242,47,4,chroma_acts
524,6,115.71199999999999,121.952,6.240000000000009,242,255,13,4,chroma_acts
524,7,121.952,151.712,29.75999999999999,255,317,62,4,chroma_acts
524,8,151.712,173.792,22.080000000000013,317,363,46,4,chroma_acts
524,9,173.792,278.912,105.11999999999998,363,581,218,4,chroma_acts
526,1,0.0,14.901333333333332,14.901333333333332,0,32,32,3,chroma_acts
526,2,14.901333333333332,21.621333333333332,6.720000000000001,32,46,14,3,chroma_acts
526,3,21.621333333333332,30.261333333333333,8.64,46,64,18,3,chroma_acts
526,4,30.261333333333333,87.38133333333333,57.12,64,183,119,3,chroma_acts
526,5,87.38133333333333,107.54133333333333,20.159999999999997,183,225,42,3,chroma_acts
526,6,107.54133333333333,139.7013333333333,32.15999999999998,225,292,67,3,chroma_acts
526,7,139.7013333333333,145.46133333333333,5.760000000000019,292,304,12,3,chroma_acts
526,8,145.46133333333333,152.18133333333333,6.719999999999999,304,318,14,3,chroma_acts
526,9,152.18133333333333,182.845,30.66366666666667,318,380,62,3,chroma_acts
527,1,0.0,14.389333333333333,14.389333333333333,0,31,31,4,chroma_acts
527,2,14.389333333333333,26.592000000000002,12.20266666666667,31,57,26,4,chroma_acts
527,3,26.592000000000002,30.346666666666668,3.7546666666666653,57,65,8,4,chroma_acts
527,4,30.346666666666668,75.40266666666666,45.056,65,161,96,4,chroma_acts
527,5,75.40266666666666,100.27733333333333,24.87466666666667,161,214,53,4,chroma_acts
527,6,100.27733333333333,119.05066666666666,18.773333333333326,214,254,40,4,chroma_acts
527,7,119.05066666666666,135.008,15.957333333333352,254,288,34,4,chroma_acts
527,8,135.008,165.984,30.976,288,354,66,4,chroma_acts
527,9,165.984,180.193,14.209000000000003,354,383,29,4,chroma_acts
528,1,0.0,8.256,8.256,0,18,18,5,chroma_acts
528,2,8.256,15.765333333333333,7.509333333333332,18,34,16,5,chroma_acts
528,3,15.765333333333333,60.82133333333333,45.056,34,130,96,5,chroma_acts
528,4,60.82133333333333,68.8,7.978666666666669,130,147,17,5,chroma_acts
528,5,68.8,72.08533333333332,3.2853333333333268,147,154,7,5,chroma_acts
528,6,72.08533333333332,75.84,3.7546666666666795,154,162,8,5,chroma_acts
528,7,75.84,83.34933333333333,7.5093333333333305,162,178,16,5,chroma_acts
528,8,83.34933333333333,90.85866666666666,7.5093333333333305,178,194,16,5,chroma_acts
528,9,90.85866666666666,168.162,77.30333333333334,194,357,163,5,chroma_acts
529,1,0.0,7.4879999999999995,7.4879999999999995,0,17,17,4,chroma_acts
529,2,7.4879999999999995,11.157333333333332,3.6693333333333324,17,25,8,4,chroma_acts
529,3,11.157333333333332,14.826666666666666,3.6693333333333342,25,33,8,4,chroma_acts
529,4,14.826666666666666,18.496,3.6693333333333324,33,41,8,4,chroma_acts
529,5,18.496,40.05333333333333,21.55733333333333,41,88,47,4,chroma_acts
529,6,40.05333333333333,102.89066666666666,62.83733333333333,88,225,137,4,chroma_acts
529,7,102.89066666666666,143.25333333333333,40.36266666666667,225,313,88,4,chroma_acts
529,8,143.25333333333333,158.38933333333333,15.135999999999996,313,346,33,4,chroma_acts
529,9,158.38933333333333,216.289,57.89966666666666,346,471,125,4,chroma_acts
530,1,0.0,31.509333333333334,31.509333333333334,0,68,68,5,chroma_acts
530,2,31.509333333333334,46.05866666666667,14.549333333333333,68,99,31,5,chroma_acts
530,3,46.05866666666667,49.81333333333333,3.7546666666666653,99,107,8,5,chroma_acts
530,4,49.81333333333333,91.11466666666666,41.30133333333333,107,195,88,5,chroma_acts
530,5,91.11466666666666,121.62133333333333,30.50666666666666,195,260,65,5,chroma_acts
530,6,121.62133333333333,125.37599999999999,3.7546666666666653,260,268,8,5,chroma_acts
530,7,125.37599999999999,144.61866666666668,19.242666666666693,268,309,41,5,chroma_acts
530,8,144.61866666666668,158.69866666666667,14.079999999999984,309,339,30,5,chroma_acts
530,9,158.69866666666667,193.075,34.37633333333332,339,411,72,5,chroma_acts
533,1,0.0,9.226666666666667,9.226666666666667,0,20,20,5,chroma_acts
533,2,9.226666666666667,16.906666666666666,7.68,20,36,16,5,chroma_acts
533,3,16.906666666666666,24.586666666666666,7.68,36,52,16,5,chroma_acts
533,4,24.586666666666666,31.786666666666665,7.199999999999999,52,67,15,5,chroma_acts
533,5,31.786666666666665,93.22666666666666,61.44,67,195,128,5,chroma_acts
533,6,93.22666666666666,100.90666666666667,7.680000000000007,195,211,16,5,chroma_acts
533,7,100.90666666666667,108.10666666666667,7.200000000000003,211,226,15,5,chroma_acts
533,8,108.10666666666667,115.78666666666666,7.679999999999993,226,242,16,5,chroma_acts
533,9,115.78666666666666,170.017,54.230333333333334,242,353,111,5,chroma_acts
534,1,0.0,5.546666666666666,5.546666666666666,0,12,12,4,chroma_acts
534,2,5.546666666666666,22.826666666666664,17.279999999999998,12,48,36,4,chroma_acts
534,3,22.826666666666664,37.22666666666667,14.400000000000002,48,78,30,4,chroma_acts
534,4,37.22666666666667,81.86666666666666,44.63999999999999,78,171,93,4,chroma_acts
534,5,81.86666666666666,83.78666666666666,1.9200000000000017,171,175,4,4,chroma_acts
534,6,83.78666666666666,109.22666666666666,25.439999999999998,175,228,53,4,chroma_acts
534,7,109.22666666666666,121.70666666666666,12.480000000000004,228,254,26,4,chroma_acts
534,8,121.70666666666666,170.953,49.24633333333334,254,355,101,4,chroma_acts
535,1,0.0,8.725333333333333,8.725333333333333,0,19,19,5,chroma_acts
535,2,8.725333333333333,30.80533333333333,22.08,19,65,46,5,chroma_acts
535,3,30.80533333333333,67.28533333333333,36.48,65,141,76,5,chroma_acts
535,4,67.28533333333333,72.08533333333332,4.799999999999997,141,151,10,5,chroma_acts
535,5,72.08533333333332,90.32533333333333,18.24000000000001,151,189,38,5,chroma_acts
535,6,90.32533333333333,118.16533333333332,27.83999999999999,189,247,58,5,chroma_acts
535,7,118.16533333333332,140.24533333333332,22.08,247,293,46,5,chroma_acts
535,8,140.24533333333332,181.52533333333332,41.28,293,379,86,5,chroma_acts
535,9,181.52533333333332,189.765,8.239666666666665,379,395,16,5,chroma_acts
540,1,0.0,31.893333333333334,31.893333333333334,0,68,68,3,chroma_acts
540,2,31.893333333333334,60.522666666666666,28.62933333333333,68,129,61,3,chroma_acts
540,3,60.522666666666666,62.4,1.8773333333333326,129,133,4,3,chroma_acts
540,4,62.4,77.41866666666665,15.018666666666654,133,165,32,3,chroma_acts
540,5,77.41866666666665,107.45599999999999,30.037333333333336,165,229,64,3,chroma_acts
540,6,107.45599999999999,121.06666666666666,13.610666666666674,229,258,29,3,chroma_acts
540,7,121.06666666666666,122.47466666666666,1.4080000000000013,258,261,3,3,chroma_acts
540,8,122.47466666666666,169.33,46.85533333333335,261,359,98,3,chroma_acts
543,1,0.0,20.394666666666666,20.394666666666666,0,44,44,5,chroma_acts
543,2,20.394666666666666,27.904,7.509333333333334,44,60,16,5,chroma_acts
543,3,27.904,66.38933333333333,38.48533333333333,60,142,82,5,chroma_acts
543,4,66.38933333333333,75.30666666666666,8.917333333333332,142,161,19,5,chroma_acts
543,5,75.30666666666666,106.28266666666666,30.976,161,227,66,5,chroma_acts
543,6,106.28266666666666,126.464,20.181333333333342,227,270,43,5,chroma_acts
543,7,126.464,135.38133333333334,8.917333333333346,270,289,19,5,chroma_acts
543,8,135.38133333333334,166.35733333333334,30.976,289,355,66,5,chroma_acts
543,9,166.35733333333334,184.329,17.971666666666664,355,392,37,5,chroma_acts
544,1,0.0,49.94133333333333,49.94133333333333,0,105,105,4,chroma_acts
544,2,49.94133333333333,91.22133333333333,41.28,105,191,86,4,chroma_acts
544,3,91.22133333333333,116.18133333333333,24.959999999999994,191,243,52,4,chroma_acts
544,4,116.18133333333333,121.94133333333333,5.760000000000005,243,255,12,4,chroma_acts
544,5,121.94133333333333,146.90133333333333,24.959999999999994,255,307,52,4,chroma_acts
544,6,146.90133333333333,155.5413333333333,8.639999999999986,307,325,18,4,chroma_acts
544,7,155.5413333333333,182.90133333333333,27.360000000000014,325,382,57,4,chroma_acts
544,8,182.90133333333333,289.524,106.62266666666667,382,603,221,4,chroma_acts
545,1,0.0,18.336,18.336,0,40,40,5,chroma_acts
545,2,18.336,48.84266666666666,30.50666666666666,40,105,65,5,chroma_acts
545,3,48.84266666666666,77.00266666666666,28.159999999999997,105,165,60,5,chroma_acts
545,4,77.00266666666666,78.88,1.8773333333333397,165,169,4,5,chroma_acts
545,5,78.88,86.38933333333333,7.5093333333333305,169,185,16,5,chroma_acts
545,6,86.38933333333333,89.67466666666667,3.285333333333341,185,192,7,5,chroma_acts
545,7,89.67466666666667,96.71466666666666,7.039999999999992,192,207,15,5,chroma_acts
545,8,96.71466666666666,128.836,32.121333333333354,207,274,67,5,chroma_acts
546,1,0.0,41.09866666666666,41.09866666666666,0,90,90,4,chroma_acts
546,2,41.09866666666666,51.64799999999999,10.54933333333333,90,113,23,4,chroma_acts
546,3,51.64799999999999,109.89866666666666,58.25066666666667,113,240,127,4,chroma_acts
546,4,109.89866666666666,122.74133333333332,12.84266666666666,240,268,28,4,chroma_acts
546,5,122.74133333333332,150.71999999999997,27.978666666666655,268,329,61,4,chroma_acts
546,6,150.71999999999997,169.52533333333332,18.80533333333335,329,370,41,4,chroma_acts
546,7,169.52533333333332,202.093,32.56766666666667,370,440,70,4,chroma_acts
547,1,0.0,58.037333333333336,58.037333333333336,0,124,124,6,chroma_acts
547,2,58.037333333333336,73.056,15.018666666666661,124,156,32,6,chroma_acts
547,3,73.056,84.32,11.263999999999996,156,180,24,6,chroma_acts
547,4,84.32,91.82933333333334,7.509333333333345,180,196,16,6,chroma_acts
547,5,91.82933333333334,121.86666666666666,30.037333333333322,196,260,64,6,chroma_acts
547,6,121.86666666666666,196.96,75.09333333333335,260,420,160,6,chroma_acts
547,7,196.96,211.50933333333333,14.549333333333323,420,451,31,6,chroma_acts
547,8,211.50933333333333,252.81066666666666,41.30133333333333,451,539,88,6,chroma_acts
547,9,252.81066666666666,294.722,41.91133333333332,539,627,88,6,chroma_acts
548,1,0.0,18.890666666666668,18.890666666666668,0,41,41,5,chroma_acts
548,2,18.890666666666668,33.909333333333336,15.018666666666668,41,73,32,5,chroma_acts
548,3,33.909333333333336,63.946666666666665,30.03733333333333,73,137,64,5,chroma_acts
548,4,63.946666666666665,96.8,32.85333333333333,137,207,70,5,chroma_acts
548,5,96.8,111.34933333333333,14.549333333333337,207,238,31,5,chroma_acts
548,6,111.34933333333333,125.42933333333333,14.079999999999998,238,268,30,5,chroma_acts
548,7,125.42933333333333,171.89333333333335,46.46400000000001,268,367,99,5,chroma_acts
548,8,171.89333333333335,206.15466666666666,34.26133333333331,367,440,73,5,chroma_acts
548,9,206.15466666666666,218.284,12.129333333333335,440,464,24,5,chroma_acts
550,1,0.0,8.16,8.16,0,18,18,6,chroma_acts
550,2,8.16,67.29599999999999,59.135999999999996,18,144,126,6,chroma_acts
550,3,67.29599999999999,114.69866666666665,47.40266666666666,144,245,101,6,chroma_acts
550,4,114.69866666666665,120.33066666666666,5.632000000000005,245,257,12,6,chroma_acts
550,5,120.33066666666666,180.40533333333332,60.07466666666666,257,385,128,6,chroma_acts
550,6,180.40533333333332,195.42399999999998,15.018666666666661,385,417,32,6,chroma_acts
550,7,195.42399999999998,202.93333333333334,7.509333333333359,417,433,16,6,chroma_acts
550,8,202.93333333333334,255.49866666666665,52.565333333333314,433,545,112,6,chroma_acts
550,9,255.49866666666665,266.043,10.544333333333356,545,566,21,6,chroma_acts
551,1,0.0,34.602666666666664,34.602666666666664,0,73,73,5,chroma_acts
551,2,34.602666666666664,69.16266666666667,34.56,73,145,72,5,chroma_acts
551,3,69.16266666666667,76.84266666666666,7.679999999999993,145,161,16,5,chroma_acts
551,4,76.84266666666666,80.68266666666666,3.8400000000000034,161,169,8,5,chroma_acts
551,5,80.68266666666666,84.52266666666667,3.8400000000000034,169,177,8,5,chroma_acts
551,6,84.52266666666667,92.20266666666666,7.679999999999993,177,193,16,5,chroma_acts
551,7,92.20266666666666,96.04266666666666,3.8400000000000034,193,201,8,5,chroma_acts
551,8,96.04266666666666,107.56266666666666,11.519999999999996,201,225,24,5,chroma_acts
551,9,107.56266666666666,165.09,57.527333333333345,225,343,118,5,chroma_acts
552,1,0.0,7.349333333333333,7.349333333333333,0,16,16,5,chroma_acts
552,2,7.349333333333333,38.54933333333333,31.199999999999996,16,81,65,5,chroma_acts
552,3,38.54933333333333,53.42933333333333,14.880000000000003,81,112,31,5,chroma_acts
552,4,53.42933333333333,84.14933333333333,30.72,112,176,64,5,chroma_acts
552,5,84.14933333333333,99.98933333333333,15.840000000000003,176,209,33,5,chroma_acts
552,6,99.98933333333333,131.18933333333334,31.200000000000003,209,274,65,5,chroma_acts
552,7,131.18933333333334,145.10933333333335,13.920000000000016,274,303,29,5,chroma_acts
552,8,145.10933333333335,209.656,64.54666666666665,303,436,133,5,chroma_acts
553,1,0.0,19.989333333333335,19.989333333333335,0,42,42,4,chroma_acts
553,2,19.989333333333335,30.549333333333333,10.559999999999999,42,64,22,4,chroma_acts
553,3,30.549333333333333,73.74933333333333,43.19999999999999,64,154,90,4,chroma_acts
553,4,73.74933333333333,87.66933333333333,13.920000000000002,154,183,29,4,chroma_acts
553,5,87.66933333333333,106.86933333333333,19.200000000000003,183,223,40,4,chroma_acts
553,6,106.86933333333333,114.54933333333332,7.679999999999993,223,239,16,4,chroma_acts
553,7,114.54933333333332,129.42933333333335,14.880000000000024,239,270,31,4,chroma_acts
553,8,129.42933333333335,213.875,84.44566666666665,270,444,174,4,chroma_acts
